Wo, Wo, Wo, Wo, Wo, Wo, Wo, Wo, Wo, Wo, Wo, Wo, Wo, Wo, Wo, Wo, Wo, Wo, Wo, Wo, Wo, Wo, Wo, Wo, Wo, Wo, Wo, Wo, Wo, Wo, Wo, Wo, Wo, Wo, Wo, Wo, Wo, Wo, Wo, Wo, Wo, Wo, Wo, Wo, Wo, Wo, Wo, Wo, Wo, Wo, Wo, Wo, Wo, Wo, Wo, Wo, Wo, Wo, Mm
Wo, Wo, Wo, Wo, Wo, Wo, Wo, Wo, Wo, Wo, Wo, Wo, Wo, Wo, Wo, Wo, Wo, Wo, Wo, Wo, Wo, Wo, Wo, Wo, Wo, Wo, Wo, Wo, Wo, Wo, Wo, Wo, Wo, Wo, Wo, Wo, Wo, Wo, Wo, Wo, Mm, Wo, Mm, Wo, Mm, Wo, Wo, Wo, Wo, Wo, Wo, Wo, Mm, Wo, Mm, Wo, Ww^Ewl, Mm, Mm
Wo, Wo, Wo, Wo, Wo, Wo, Wo, Wo, Wo, Wo, Wo, Wo, Wo, Wo, Wo, Wo, Wo, Wo, Wo, Wo, Wo, Wo, Wo, Wo, Wo, Wo, Wo, Wo, Wo, Wo, Wo, Wo, Wo, Wo, Wo, Wo, Wo, Wo, Wo, Wo, Wo, Mm, Mm, Mm, Mm, Ds^Esd, Wo, Wo, Wo, Wo, Mm, Mm, Mm, Mm, Ds^Esd, Wo, Mm, Mm, Mm
Wo, Wo, Wo, Wo, Wo, Wo, Wo, Wo, Wo, Wo, Wo, Wo, Wo, Wo, Wo, Wo, Wo, Wo, Wo, Wo, Wo, Wo, Wo, Wo, Wo, Wo, Wo, Wo, Wo, Wo, Mm, Mm, Mm, Wo, Wo, Wo, Wo, Wo, Wo, Wo, Wo, Mm, Mm, Mm, Mm, Ds, Wo, Wo, Wo, Wo, Mm, Mm, Mm, Mm, Xos, Ds, Gll^Fdf, Mm, Mm
Wo, Wo, Wo, Wo, Wo, Wo, Wo, Wo, Wo, Wo, Wo, Wo, Wo, Wo, Wo, Wo, Wo, Wo, Wo, Wo, Wo, Wo, Wo, Wo, Wo, Wo, Wo, Wo, Wo, Mm, Mm, Gll^Fdf, Xos, Xos, Wo^Es, Wo, Wo, Wo, Wo, Wo, Mm, Mm, Mm, Mm, Wo, Wo, Wo, Wo, Wo, Ww^Ewl, Mm, Mm, Mm, Mm, Xos, Xos, Xos, Mm, Mm
Wo, Wo, Wo, Wo, Wo, Wo, Wo, Wo, Wo, Wo, Wo, Wo, Wo, Wo, Wo, Wo, Wo, Wo, Wo, Wo, Wo, Wo, Wo, Wo, Wo, Wo, Wo, Wo, Wo, Mm, Ds, Xos, Xos, Tsb, Rr, Wo, Wo, Wo, Wo, Wo, Mm, Mm, Mm, Wo, Wo, Wo, Gll, Wo, Gll^Fdf, Gll^Fdf, Xos, Mm, Xos, Xos, Irs, Irs, Irs, Xos, Xos
Wo, Wo, Wo, Wo, Wo, Wo, Wo, Wo, Wo, Wo, Wo, Wo, Wo, Wo, Wo, Wo, Wo, Wo, Wo, Wo, Wo, Wo, Wo, Wo, Wo, Wo, Wo, Wo, Wo, Wo, Ds^Esd, Mm, Mm, Xos, Rr, Wo, Wo, Wo, Wo, Mm, Mm, Mm, Rd^Es, Ds^Esd, Ds, Gll^Fdf, Gll^Fdf, Ds^Esd, Gll^Fdf, Gll^Fdf, Xos, Xos, Irs, Irs, Irs, Xos, Xos, Irs, Irs
Wo, Wo, Wo, Wo, Wo, Wo, Wo, Wo, Wo, Wo, Wo, Wo, Wo, Wo, Wo, Wo, Wo, Wo, Wo, Wo, Wo, Wo, Wo, Wo, Wo, Wo, Wo, Wo, Wo, Wo, Wo, Ds, Mm, Mm, Rr, Wo, Wo, Wo, Mm, Mm, Mm, Rd^Es, Mm, Mm, Gll^Fdf, Gll^Fdf, Gd, Gll^Fdf, Gll^Efm, Gll^Fdf, Xos, Irs, Irs, Xos, Xos, 3 Irs, Xos, Xos, Xos
Wo, Wo, Wo, Wo, Wo, Wo, Wo, Wo, Wo, Wo, Wo, Wo, Wo, Wo, Wo, Wo, Wo, Wo, Wo, Wo, Wo, Wo, Wo, Wo, Wo, Wo, Wo, Wo, Wo, Wo, Mm, Mm, Mm, Mm, Mm, Rr, Rr, Mm, Mm, Mm, Rd^Es, Rd^Es, Xos, Rd^Es, Mm, Mm, Gd, Ww^Ewf, Xos, Xos, Irs^Ebn, Xos, Xos, Irs, Irs, Xos, Xos, Irs, Irs
Wo, Wo, Wo, Wo, Wo, Wo, Wo, Wo, Wo, Wo, Wo, Wo, Wo, Wo, Wo, Wo, Wo, Wo, Wo, Wo, Wo, Wo, Wo, Wo, Mm, Mm, Ww^Ewl, Wo, Wo, Wo, Mm, Mm, Mm, Mm, Mm, Mm, Mm, Rr, Rr, Rd^Es, Xos, Xos, Gd, Xos, Xos, Mm, Gll^Fdf, Gll^Fdf, Xos, Irs^Ebn, Irs, Irs, Irs, Irs^Pr\o, Irs^Pr\o, Irs, Irs, Xos, Irs
Wo, Wo, Wo, Wo, Wo, Wo, Wo, Wo, Wo, Wo, Wo, Wo, Wo, Wo, Wo, Wo, Wo, Wo, Mm, Wo, Ds, Wo, Mm, Wo, Mm, Mm, Mm, Wo, Mm, Wo, Wo, Mm, Mm, Mm, Xos, Mm, Mm, Rd^Es, Xos, Rr^Pr/, Rrc, Gll, Gll^Tscb, Gd, Rd^Es, Xos, Xos, Gll^Fdf, Xos, Xos, Irs^Pr\o, Irs, Irs, Irs, Irs, Xos, Xos, Irs, Xos
Wo, Wo, Wo, Wo, Wo, Wo, Wo, Wo, Wo, Wo, Wo, Wo, Wo, Wo, Wo, Wo, Wo, Mm, Mm, Mm, Mm, Mm, Mm, Mm, Xos, Mm, Mm, Mm, Mm, Wo, Ww^Ewl, Mm, Xos, Xos, Tsb, Xos, Xos, Xos, Gd, Rrc, Gll^Tscb, Rrc, Rrc, Rrc, Gll^Tscb, Rd^Es, Xos, Xos, Irs, Irs, Irs, Irs^Pr\o, Xos, Irs, Irs^Ebn, Irs^Ebn, Xos, Xos, Mm
Wo, Wo, Wo, Wo, Wo, Wo, Wo, Wo, Wo, Wo, Wo, Wo, Wo, Wo, Wo, Wo, Wo, Mm, Mm, Mm, Mm, Mm, Xos, Xos, Tsb, Xos, Xos, Mm, Mm, Mm, Mm, Mm, Xos, Tsb, Rrc^Es, Gll^Tscb, Rrc, Gll^Es, Gll^Es, Rrc, Gll^Es, Gd, Rrc, Gd, Gll^Es, Rrc^Ebn, Rrc, Irs^Pr\o, Irs^Pr\o, Irs, Xos, Xos, Mm, Xos, Xos, Xos, Mm, Mm, Mm
Wo, Wo, Wo, Wo, Wo, Wo, Wo, Wo, Wo, Wo, Wo, Wo, Wo, Wo, Wo, Wo, Wo, Ds, Gll^Fdf, Mm, Xos, Xos, Rd^Es, Tsb, Tsb, Tsb, Tsb, Xos, Mm, Mm, Mm, Mm, Xos, Rd^Es, Rrc, Rrc, Gll^Tscb, Rrc, Rrc, Rrc^Es, Rrc^Es, Gll^Tscb, Rrc, Rrc, 1 Rrc, Rrc, Rrc, Rrc, Rrc^Ebn, Xos, Xos, Mm, Mm, Mm, Mm, Mm, Mm, Mm, Mm
Wo, Wo, Wo, Wo, Wo, Wo, Wo, Wo, Ds, Mm, Gll^Fdf, Wo, Mm, Wo, Wo, Wo, Ds, Ds, Xos, Xos, Rd^Es, Rd^Es, Rd^Eff, Rd^Efs, Rd^Efs, Tsb, Rd^Efs, Xos, Xos, Mm, Xos, Xos, Gll, Gll^Tscb, Gll, Gll, Rrc^Es, Rrc, Gd, Gll^Es, Gll^Tscb, Rrc, Rrc, Gll^Tscb, Rrc^Es, Rrc, Gll^Fdf, Gll^Fdf, Ww, Rd^Es, Xos, Mm, Mm, Mm, Mm, Mm, Mm, Mm, Mm
Wo, Wo, Wo, Wo, Wo, Wo, Wo, Mm, Mm, Mm, Gd, Mm, Gll^Tsfh, Wo, Ds, Mm, Mm, Mm, Xos, Rd^Tsmh, Rd^Es, Rd^Es, Rd^Es, Rd^Es, Rd^Es, Rd^Es, Rd^Pw/o, Rd^Pw/, Gd, Xos, Gll^Tscb, Gll^Pr\, Gll^Pr\, Gll, Rrc^Es, Rrc, Gll^Tscb, Rrc, Rrc, Gll^Es, Rrc, Gll^Tscb, Gll^Es, Rrc, Rrc, Gs, Gll^Fdf, Gll^Fdf, Rd^Es, Rd^Es, Xos, Mm, Mm, Mm, Mm, Mm, Mm, Mm, Mm
Wo, Wo, Wo, Wo, Wo, Wo, Wo, Wo, Gll^Gvs, Gll^Gvs, Gll^Gvs, Gll^Gvs, Gll^Gvs, Gll^Gvs, Gll^Gvs, Gll^Fdf, Gll^Fdf, Gll^Fdf, Xos, Rd^Tsmh, Rd^Es, Rd^Es, Wo, Wo, Rb^Pw/, Rb^Pw/, Gll, Rd, Rr, Gll, Rr, Gll, Rr, Rrc^Pr\o, Gll^Pr\, Gll, Xos, Gd, Gll^Es, Rrc, Rd^Tscb, Rrc, Rrc^Es, Rrc, Rrc^Es, Rd, Rd^Eff, Rd^Eff, Rd^Es, Rd^Es, Xos, Gll, Mm, Mm, Mm, Mm, Mm, Mm, Mm
Wo, Wo, Wo, Wo, Wo, Wo, Wo, Wo, Gll^Gvs, Gll^Gvs, Gll^Gvs, Gll^Gvs, Gll^Gvs, Gll^Gvs, Gll^Gvs, Gll^Fdf, Gll^Fdf, Gll^Fdf, Xos, Xos, Xuc, Xuc, Wo, Xuc, Sm^Ftp, Sm^Ftp, Rb, Gll^Tscb, Gll, Rr, Gll^Tscb, Rr, Rr, Gd, Gll^Tscb, Xos, Gll^Tscb, Gll^Tscb, Gll, Rrc, Rd^Es, Rd^Esd, Rd^Es, Rd^Tscb, Rrc, Rrc^Es, Rrc, Rd^Eff, Rd^Eff, Rd^Tsmh, Xos, Rd^Es, Gll^Fdf, Mm, Mm, Mm, Mm, Mm, Mm
Wo, Wo, Wo, Wo, Wo, Wo, Wo, Wo, Wo, Ww^Ewf, Gll^Gvs, Gll^Gvs, Gd, Gll^Fdf, Gll^Fdf, Gd, Xos, Xos, Cer, Ker, Cer, Xuc, Rb^Ftp, Wo, Ww^Bp/, Rb, Xuc, Ds, Gd, Gd, Rr, Rr, Gd, Gll^Tscb, Xuc, Xos, Xos, Gll^Tscb, Gd, Rrc, Rrc, Rd^Tscb, Rd^Es, Rrc^Es, Rrc, Gd, Gll^Tscb, Rrc, Rr^Pr/, Xos, Rr, Gll^Fdf, Gll^Fdf, Mm, Mm, Mm, Mm, Mm, Mm
Wo, Wo, Wo, Wo, Wo, Wo, Wo, Wo, Wo, Gll^Tsfh, Gll^Gvs, Gll^Gvs, Gll^Gvs, Gll^Fdf, Xos, Gd, Xos, Sm^Ftp, Sm^Tssh, Rb, Rb^Ftp, Sm^Tssh, Rb^Ftp, Rb^Es, Rb^Ftp, Sm^Tssh, Ww, Rb^Ftp, Gll^Tscb, Gll^Tscb, Rr, Gll^Tscb, Gd, Gd, Rd^Es, Rd^Es, Gll^Tssh, Xos, Xos, Xos, Gll, Rrc^Es, Rrc^Es, Rrc^Es, Rrc^Es, Gll^Tscb, Xos, Xos, Gll, Rr, Wo, Wo, Wo, Wo^Es, Wo, Mm, Gll^Fdf, Mm, Mm
Wo, Wo, Ds, Wo, Mm, Wo, Mm, Wo, Ds, Wo, Gll^Gvs, Gll^Gvs, Gll^Fdf, Gll^Fdf, Gll^Fdf, Xos, Xos, Sm^Ftp, Ww^Ewf, Sm^Ftp, Ww, Sm, Rb^Ftp, Xuc, Sm^Tssh, Sm, Ww, Rb^Ftp, Ww, Rr, Rr, Rd, Rd, Rd, Rd, Rd^Es, Rd^Pw/, Xuc, Gll^Tssh, Xos, Gd^Tscb, 2 Gs, Gd, Rrc^Es, Xuc, Xos, Xos, Gll, Gll, Rr, Ww^Ewf, Wo, Wo, Wo, Wo, Gll^Fdf, Wo, Mm, Wo
Wo, Wo, Mm, Mm, Mm, Mm, Mm, Mm, Mm, Gll^Gvs, Gll^Gvs, Gll^Fdf, Gll^Fdf, Gll^Fdf, Gll^Fdf, Gll^Fdf, Xos, Sm^Tssh, Sm^Ftp, Sm^Ftp, Rb, Ww^Bp/, Ww, Sm, Gll^Tscb, Rb^Ftp, Gll^Tscb, Ww, Rr, Wo^Bsb/, Ww, Gll, Gll^Tscb, Gd, Rd^Pw/, Rd, Rd, Rd^Es, Rd^Es, Xos, Xos, Gd, Gll, Rrc, Rrc, Gll^Tscb, Gll, Xos, Xos, Rr, Rr, Rd^Es, Tsb, Wo, Wo, Rd^Es, Wo^Es, Wo, Wo
Wo, Wo, Mm, Mm, Mm, Mm, Mm, Mm, Ww^Ewf, Gll^Gvs, Gll^Gvs, Gll^Gvs, Gll^Fdf, Xos, Xos, Xos, Gll^Tscb, Gll^Tscb, Gll^Es, Gll^Tscb, Rr, Gd, Gd, Gd, Gll^Tscb, Gd, Rr, Rr, Gll^Tscb, Gll, Xuc, Ww, Ww, Xuc, Rd^Es, Gll, Gll, Rd, Xos, Xos, Gll, Gll, Gd, Gll^Tscb, Rrc, Gll, Gd, Tsb, Xos, Mm, Mm, Xos, Xos, Ds, Wo^Es, Wo, Wo, Wo, Wo
Wo, Mm, Mm, Mm, Mm, Wo, Wo, Mm, Gll^Tsfh, Gll^Gvs, Gll^Gvs, Gll^Gvs, Gd, Gll^Fdf, Xos, Sm^Ftp, Gll^Tscb, Rr, Gll^Tscb, Gll^Tscb, Rr, Gll^Tscb, Gll^Tscb, Gd, Rr, Rr, Rr, Gd, Rd^Pw/, Xuc, Rd^Es, Tsb, Ds, Ww, Gd, Gd, Gll, Rd, Rd, Xos, Gll^Pr\, Rd^Es, Rrc, Rrc, Gll, Gll, Rd^Es, Tsb, Xos, Mm, Mm, Mm, Mm, Wo^Es, Wo^Es, Wo, Wo, Wo, Wo
Wo, Wo, Ds, Mm, Mm, Mm, Wo, Mm, Gll^Gvs, Gll^Gvs, Gll^Gvs, Gd, Gll^Fdf, Gll^Fdf, Xos, Sm^Tssh, Rb^Tscb, Rr, Rr, Rr, Rb^Tscb, Rr, Rr, Rr, Gll^Tscb, Gll, Rd^Pw/, Rr^Pw/o, Rr, Gll, Gll^Tscb, Rd^Es, Rd^Es, Ww, Ww, Gd, Ww, Gd, Rd, Gd, Rr, Rrc^Pr\o, Gll^Pr\, Gll, Tsb, Gll, Xos, Xos, Mm, Gll^Fdf, Wo, Wo, Wo, Wo, Wo, Wo, Wo, Wo, Wo
Wo, Wo, Wo, Ds, Mm, Mm, Mm, Wo, Wo, Wo, Wo, Gll^Fdf, Xos, Xos, Rb^Tscb, Gll^Pw\, Gll^Pw\, Rb^Tscb, Rr, Gd, Ds, Gll, Rr, Gll, Tsb, Xuc, Gll, Gd, Gll^Es, Rr, Rr, Rr, Gll^Tscb, Gll^Tscb, Gll^Tscb, Ww, Gll, Ww, Wo^Bsb/, Rr, Gll, Gd, Rd^Es, Xos, Xos, Xos, Mm, Gll^Fdf, Mm, Gll^Fdf, Gll, Wo, Wo, Wo, Wo, Wo, Wo, Wo, Wo
Wo, Wo, Mm, Mm, Mm, Mm, Mm, Gll, Gll, Gll, Wo, Xos, Tsb, Rb^Tscb, Rb^Tscb, Rd, Rr, Rr^Pw\o, Re^Pw\, Gll, Gll^Tscb, Gll^Tscb, Gd, Rr, Tsb, Xuc, Tsb, Gd, Gll, Gll^Tscb, Rr, Gd, Gll^Tscb, Rr, Rr, Gll, Rr, Rr, Gll, Ww, Gll, Gll^Tscb, Xos, Tsb, Xos, Mm, Wo, Wo, Re, Mm, Gll^Fdf, Wo, Wo, Wo, Wo, Wo, Wo, Wo, Wo
Wo, Wo, Mm, Mm, Ds, Mm, Mm, Mm, Wo, Wo, Gll, Xos, Tsb, Gll^Tscb, Rp, Rr, Gll^Tscb, Rb^Tscb, Xuc, Xuc, Xuc, Gd, Gll^Tscb, Rd^Es, Xos, Xos, Xos, Xos, Xos, Rd^Es, Rr, Gll, Rr, Rr, Gd, Rr, Gll, Gll^Tscb, Gll, Ww, Xos, Xos, Gll^Fdf, Xos, Mm, Mm, Wo, Wo, Wo, Wo, Gll, Wo, Wo, Wo, Wo, Wo, Wo, Wo, Wo
Wo, Wo, Wo, Wo, Mm, Mm, Mm, Mm, Wo, Gll^Fdf, Xos, Xos, Gll^Tscb, Rp^Efs, Gll^Es, Rr, Rp, Rb^Tscb, Tsb, Tsb, Gll^Tscb, Xuc, Xos, Xos, Wo, Wo, Wo, Wo, Wo, Wo, Rr, Rr, Ds, Gd, Gd, Gll^Tscb, Gd, Gll^Tscb, Gd, Xos, Gll^Fdf, Ww, Ww, Gll^Fdf, Wo, Mm, Mm, Wo, Wo, Wo, Wo, Wo, Wo, Wo, Wo, Wo, Wo, Wo, Wo
Wo, Wo, Wo, Wo, Gll^Fdf, Mm, Mm, Wo, Xos, Xoc, Xos, Gll, Gd, Gll, Rr, Rr, Gll^Tscb, Ds, Gll^Tscb, Rd^Efs, Xos, Xos, Wo, Xuc, Wo^Pw\, Wo, Wo, Wo, Wo, Wo^Bw/, Wwr, Xos, Tsb, Gd, Gll^Tscb, Gd, Gd, Gll^Tscb, Xos, Xos, Gll^Fdf, Gll^Fdf, Wo, Wo, Wo, Re, Mm, Wo, Wo, Wo, Wo, Wo, Wo, Wo, Wo, Wo, Wo, Wo, Wo
Wo, Wo, Wo, Wo, Mm, Gll^Fdf, Xos, Xos, Wo, Tsb, Gd, Gll^Pr\, Rr^Pr\o, Rr, Gll, Gd, Rb, Gd, Rd^Pw/o, Xos, Xos, Wo, Wo, Wo, Wo, Xuc, Wo, Wo, Wo, Wo, Ds, Xos, Xos, Xos, Xos, Gll^Tscb, Gll, Gd, Xos, Re, Wo, Wo, Wo, Wo, Wo, Wo, Wo, Wo, Wo, Wo, Wo, Wo, Wo, Wo, Wo, Wo, Wo, Wo, Wo
Wo, Wo, Wo, Gll, Gll^Fdf, Xos, Rd^Es, Gd, Gll, Wo, Wo^Bsb/, Rr^Efs, Re^Efs, Gll^Pr\, Xos, Gll, Rd^Pw/, Rd^Pw/, Rd^Es, Re, Xos, Xuc, Wo^Pw\, Wo, Xuc, Xuc, Ds, Re, Re, Wwr, Wo, Re, Re, Ds, Wo, Xos, Xos, Xos, Re, Gll^Fdf, Wo, Wo, Wo, Wo, Wo, Wo, Wo, Wo, Wo, Wo, Wo, Wo, Wo, Wo, Wo, Wo, Wo, Wo, Wo
Wo, Wo, Gll, Wo, Xos, Xos, Gd, Gll, Rr, Rr^Efs, Rd^Efs, Wo, Wo, Re, Gll, Xos, Tsb, Rd, Rd^Es, Rd, Xos, Wo, Wo, Xuc, Wo, Ds^Tssh, Wo, Wo, Wo, Wo, Wo, Wo, Wo, Wo, Wo, Re, Re, Ds, Ds, Gll^Fdf, Wo, Wo, Wo, Wo, Wo, Wo, Wo, Wo, Wo, Wo, Wo, Wo, Wo, Wo, Wo, Wo, Wo, Wo, Wo
Wo, Wo, Wo, Wo, Gll, Gll^Pr\, Rr^Pr\o, Rr, Gll, Gd, Tsb, Gll, Xos, Wo, Xos, Xos, Xos, Tsb, Xos, Xos, Gll^Fdf, Wo, Wo, Wo, Wo, Wo, Wo, Wo, Wo, Wo, Wo, Wo, Wo, Wo, Wo, Wo, Wo, Wo, Wo, Wo, Wo, Wo, Wo, Wo, Wo, Wo, Wo, Wo, Wo, Wo, Wo, Wo, Wo, Wo, Wo, Wo, Wo, Wo, Wo
Wo, Wo, Wo, Wo, Wo^Bsb/, Rr^Efs, Gll^Efs, Gll^Pr\, Xos, Xos, Xos, Xos, Gll^Fdf, Xos, Mm, Mm, Mm, Xos, Gll^Fdf, Ds, Wo, Gll^Fdf, Wo, Wo, Wo, Wo, Wo, Wo, Wo, Wo, Wo, Wo, Wo, Wo, Wo, Wo, Wo, Wo, Wo, Wo, Wo, Wo, Wo, Wo, Wo, Wo, Wo, Wo, Wo, Wo, Wo, Wo, Wo, Wo, Wo, Wo, Wo, Wo, Wo
Gs, Gs, Gs, Wo^Bsb/, Wo, Wo, Wo, Wo, Wo, Re, Wo, Mm, Re, Wo, Wo, Gll^Fdf, Wo, Gll^Fdf, Gll^Fdf, Wo, Wo, Wo, Wo, Wo, Wo, Wo, Wo, Wo, Wo, Wo, Wo, Wo, Wo, Wo, Wo, Wo, Wo, Wo, Wo, Wo, Wo, Wo, Wo, Wo, Wo, Wo, Wo, Wo, Wo, Wo, Wo, Wo, Wo, Wo, Wo, Wo, Wo, Wo, Wo
Gs, Gs, Gs, Gs, Gs, Wo, Wo, Wo, Wo, Wo, Wo, Wo, Wo, Wo, Wo, Wo, Wo, Rd^Es, Wo, Wo, Wo, Wo, Wo, Wo, Wo, Wo, Wo, Wo, Wo, Wo, Wo, Wo, Wo, Wo, Wo, Wo, Wo, Wo, Wo, Wo, Wo, Wo, Wo, Wo, Wo, Wo, Wo, Wo, Wo, Wo, Wo, Wo, Wo, Wo, Wo, Wo, Wo, Wo, Wo
Gs, Gs, Gs, Gs, Gs, Wo, Wo, Wo, Wo, Wo, Wo, Wo, Wo, Wo, Rd, Wo, Wo, Wo, Wo, Wo, Wo, Wo, Wo, Wo, Wo, Wo, Wo, Wo, Wo, Wo, Wo, Wo, Wo, Wo, Wo, Wo, Wo, Wo, Wo, Wo, Wo, Wo, Wo, Wo, Wo, Wo, Wo, Wo, Wo, Wo, Wo, Wo, Wo, Wo, Wo, Wo, Wo, Wo, Wo
