Rb^Ftr, Rb^Ftr, Sm, Ss, Ss, Ss, Rb^Ftr, Ss, Ss, Ss, Re^Es, Rb^Ftr, Sm^Es, Ss, Gll^Fms, Gll^Fms, Gg, Gg, Gs, Gg, Gg^Gvs, Gg, Gg^Es, Gg, Gg^Es, Wo, Gll^Fms, Gg, Gll^Fms, Gg, Gll^Fms
Ss, Rb^Es, Ss, Ss, Ss, Rb^Es, Ss, Ss, Ss, Ss, Re^Es, Rb, Rb, Ss^Vhs, Gg, Gg, Re, Re, Rb, Gg^Fms, Gg^Fms, Gg^Vh, Re, Rb^Es, Wo^Bw\, Wo, Re, Gg^Vh, Gll^Fms, Gg^Fms, Gll^Fms
Ss, Rb^Vhs, Rb^Ftr, Rb^Ftr, Sm^Em, Ss, Ss, Ss, Re^Es, Ss^Bw/r, Ss, Rb^Ftr, Rb^Es, Ss^Bw\r, Re, Rb, Gg, Gg, Gd, Rb, Gg^Fms, Re, Gs, Gg^Fms, Wo, Rd, Gg^Es, Rb, Re, Gg^Efm, Gg
Ss, Rb^Es, Re, Rb, Rb, Re^Es, Rb, Rb^Ftr, Rb^Es, Ss, Ss, Ss, Sm, Ss, Ss, Ch, Gg^Vh, Gg^Gvs, Gg, Rb, Re, Rb, Gg, Wo, Wo, Wo, Wo, Gll^Fms, Rb, Wo, Gg
Rb^Ftr, Rb^Ftr, Ce, Rb^Ftr, Ce, Rb, Sm^Em, Re^Es, Ss^Bw\r, Ss, Rb^Ftr, Ss, Sm^Em, Rb^Es, Rb^Ftr, Ss, Ss, Gd, Gg, Gg, Gg, Gg, Ss, Ww^Ewl, Ss, Wo, Gg, Gll^Fms, Gg, Re, Gg^Fms
Ss, Rb, 4 Re^Es, 1 Ket, Ce, Rb^Ftr, Rb^Ftr, Rb^Ftr, Ss^Vhs, Re, Rb, Re, Sm^Vhs, Rb^Ftr, Re^Es, Rb^Ftr, Ss, Gg, Gs, Gg, Gg^Fms, Ss, Ss, Ww^Ewl, Gg^Es, Gd, Gll^Fms, Gg^Es, Rb, Re, Gg^Fms
Ss, Rb^Ftr, Rb^Es, Ce, Rb^Es, Rb^Es, Sm, Sm^Em, Sm^Em, Rb^Ftr, Re^Es, Rb^Ftr, Rb, Ww^Ewl, Wo, Ss, Sm, Gs, Gg, Mm, Gg^Vh, Mm, Ss, Ss, Gg, Gg^Es, Gg^Es, Gll^Fms, Rb, Gg^Vh, Gg^Gvs
Ss, Ss^Vhs, Rb^Ftr, Rb^Ftr, Re, Sm^Em, Rb^Ftr, Rb^Ftr, Sm^Em, Rb^Ftr, Wo, Rb, Rb^Es, Wo^Bw\r, Rd, Ch, Gg, Gs, Gg^Gvs, Wo, Gg^Gvs, Gg^Fms, Gs, Gg, Re, Gg^Fms, Rd^Es, Re, Re, Gg^Fms, Gg^Fms
Ss, Rb, Ss, 2 Rb^Ftr, Re, Rb, Re, Ss, Ww^Ewl, Re, Ss, Wo^Bw|r, Sm, Sm, Gs, Rb, Rb, Gg^Gvs, Gg^Efm, Gg^Fms, Rb, Re, Rb, Rb, Gll^Fms, Re, Chr, Chr, Rd^Es, Gg, Rb^Es
Ss, Ss, Ss, Ww^Ewl, Rb, Rb^Ftr, Ss, Ss, Ss, Wo, Gg, Re, Ch, Gs, Gg, Gg, Rb, Gg^Vh, Re, Rb, Gg, Gg, Gg, Gg^Fms, Gd, Gs^Vh, Chr, 3 Khr, Chr, Rb^Es, Gg^Fms
Wo, Wo, Ss, Ss, Ss, Ss^Bw\r, Re, Wo, Gg, Gs, Gg^Vh, Rb, Wo, Gg, Gs, Mm, Re^Es, Rb, Gg, Gg, Gg^Fms, Gg, Gg, Gg, Gg, Gg, Gg, Gg, Gg, Rb, Gg^Fms
Mm, Wo, Mm, Wo, Wo, Wo, Ch, Rb, Gg^Es, Gg^Gvs, Rb, Rb, Gg, Wo, Gs, Rd^Es, Mm, Gg, Gg, Gg^Fms, Gg^Efm, Gg, Gg, Gg^Es, Gg, Gg, Gg^Es, Gg, Wo, Gg, Gg
Mm, Mm, Gg^Gvs, Wo, Mm, Wo, Gg, Re, Rb, Rb, Gg^Es, Rb, Rb, Gs, Rb, Re, Re^Es, Rd^Es, Re, Gg^Fms, Gg^Fms, Gg^Fms, Gd, Gg, Gg, Gg^Fms, Gg^Fms, Gg, Ww^Ewf, Wo, Gg
Mm, Gg^Gvs, Wo, Gg^Vh, Rd, Gs, Gg^Es, Gg, Re, Gg, Gd^Es, Gs^Es, Gg, Rb, Gll, Mm, Mm, Mm, Re, Gg^Vh, Gg^Gvs, Gg^Gvs, Gg, Gg, Gg, Gg, Gs, Gg^Vh, Gg^Gvs, Wo, Gg^Fms
Mm, Mm, Mm, Mm, Gg, Re, Rb, Rb, Gg, Gg, Wo, Gd^Es, Gg, Gg, Gg, Gg, Mm, Mm, Rb, Ww^Ewl, Gg, Gg, Gg, Gg, Gg, Gd, Gg^Fms, Gg^Fms, Gg, Gg^Fms, Gg
