Gs^Fds, Gs^Fds, Gs^Fds, Gs^Fms, Gs^Fms, Gs^Fms, Rb, Gs^Fds, Gs^Fds, Gs^Fms, Gs^Fms, Wo, Wo, Gs^Fms, Gs^Fms, Gs^Fms, Rb, Gs^Fms, Gs^Fds, Gs^Fms, Gs^Fms, Gs^Fms, Gs^Fds, Gs^Fms, Gs^Fms, Gs^Fms, Wo, Gs^Fms, Gs^Fms, Gs, Gs^Fms, Gs^Fms
Gs^Fms, Gll^Es, Wo, Mm, Mm, Gs^Fms, Gs^Fds, Rb, Gs^Fds, Ss, Gs^Fds, Wo, Rb^Vo, Gs^Fds, Rb, Gs^Es, Rb, Gs^Fds, Rb, Gs^Fms, Gs, Ss, Gs^Fds, Ss, Gs^Fms, Gs^Fms, Ww, Gd^Es, 4 Gs, Gs^Fds, Rb, Gs
Gs^Fds, Gs^Fds, Ss, Wo, Mm, Gd^Es, Gs^Fms, Rb, Rb, Gs^Fms, Rb, Rb, Rb, Rb, Gs^Es, Rb, Gs^Fds, Rb, Gs^Fms, Rb, Gs^Fds, Gs^Fms, Mm, Mm, Wo, Wo, Gs^Fds, Gs^Fms, Rb, Rb, Rb^Vo, Rb
Wo, Gs^Fms, Gs^Fds, Gs^Fds, Gs, Gs^Fms, Rb, Gs^Fds, Rb, Rb, Gs^Fms, Gs^Es, Rb, Gs^Fms, Gs^Fms, Gs^Efm, Ss, Gs^Fds, Rb, Rb, Cer, Gs^Fms, Wo, Mm, Ww, Gs^Fms, Gs^Efm, Gs^Fms, Rb, Mm, Mm, Gs^Fms
Gs^Fms, Wo, Rb^Vo, Rb, Gs^Fms, Rb, Gs^Fms, Rb, Gs^Es, Gs^Efm, Gs^Es, Gs^Fds, Rb, Rb, Rb, Gs, Gs^Fms, Gs^Fds, Gs^Fms, Rb^Vo, Wo, Wo^Bp\, Cer, Wo, Rb^Vo, Mm, Mm, Rb, Gs^Fms, Mm, Mm, Mm
Gs^Fms, Wo, Ww, Rb, Rb, Rb, Gs^Fds, Gs^Fds, Gs^Gvs, Gs^Gvs, Rb^Vo, Rb, Gs^Fds, Gs^Fms, Rb, Rb, Rb^Vo, Gs^Es, Ww, Ww, Cer, Wo, Rb^Es, Sm, Rb, Mm, Mm, Rb, Gs^Fds, Gs^Es, Gs^Fms, Mm
Rb, Rb^Es, Wo, Gs^Fms, Re, Gs^Fms, Wo, Gs^Fms, Wo, Ww, Ww, Rb, Gs^Fms, Gs^Es, Rb, Gs, Gs^Fms, Cer, Wo^Bp\, Ww, 3 Ker, Wo^Bp/, Ww, Gs^Fms, Gd^Es, Rb, Rb, Rb, Sm, Gs^Fms, Gs^Es, Mm
Gs^Fms, Gs^Fds, Gs^Fms, Wo, Ww, Wo, Gs^Fds, Wo, Gs, Gs^Fms, Gs^Fds, Wo, Gs^Efm, Gs^Fds, Gs^Fms, Rb, Sm, Wo, Sm^Em, Cer, Cer, Cer, Wo, Ww, Sm, Gs^Fms, Rb, Gs^Fms, Gs^Fds, Gs^Fds, Mm, Mm
Gs, Gs^Fds, Ss, Gs^Fds, Re, Gs^Fms, Gs^Gvs, Rb^Vo, Rb, Ss, Gs^Fms, Wo, Gs^Fds, Gs^Fms, Rb, Rb, Rb, Wo, Rb, Rb^Vo, Sm^Bp|, Re^Vo, Wo, Gs^Fms, Gs^Fds, Gd, Gs^Fms, Rb, Gs^Fms, Gs^Fms, Mm, Mm
Gs^Fds, Gs^Fms, Gs^Fds, Gs^Fms, Rb, Gd^Es, Gs^Fms, Gs^Fms, Rb, Gs^Fds, Gs^Fms, Ww, Wo, Wo, Wo, Cer, Wo^Bp\, Ww, Rb^Vo, Sm, Cer, Ww, Rb, Gs^Fms, Ss, Gs^Fds, Rb, Rb, Mm, Gs^Es, Gs^Fds, Mm
Gs^Fms, Gd, Rb, Rb, Gs, Gs^Fms, Wo, Gs^Fds, Rb, Rb, Rb, Gs^Fms, Gs^Fds, Gs^Fms, Rb, Ww, Wo^Bp/, Cer, Re, Rb, Wo, Wo^Bp\, Rb, Gs^Es, Gs^Fms, Rb, Rb^Vo, Gs^Fds, Mm, Mm, Gs, Gs^Fds
Gs^Fds, Gs^Es, Rb, Gs^Fds, Gs^Fms, Ss, Gs^Fds, Rb, Gs^Fds, Gs^Fms, Rb, Gs^Es, Ss, Gs^Fds, Rb, Cer, Ww, Sm^Em, Cer, Wo, Gs^Fms, Rb, Gs^Es, Rb, Rb, Rb^Es, Mm, Mm, Mm, Mm, Gd^Es, Gs^Fms
Rb, Gs^Fds, Gs^Es, Rb, Gs^Fds, Gs^Fms, Gs^Fms, Rb, Gs^Fms, Gs^Es, Gs^Fds, Rb, Rb, Cer, Cer, Gs^Fms, Wo, Ww, Ww, Ww, Gs^Fms, Gd^Efm, Gs^Fms, Rb, Gs^Fms, Gs^Fms, Mm, Mm, Gs^Fds, Mm, Gs^Fms, Gs^Fds
Gs^Fds, Rb, Rb, Rb, Rb, Gs^Fds, Rb, Rb, Gs^Fds, Gd^Efm, Gs^Fms, Rb^Vo, Cer, Ker, Gs^Fms, Wo, Re, Gs^Fms, Gs^Fms, Gs^Fds, Gs^Es, Gs^Fms, Mm, Rb, Rb, Mm, Gs^Fms, Ss, Gs^Fds, Gd, Gs^Efm, Gs
Gs^Fms, Gs^Fds, Mm, Rb^Vo, Gs^Fms, Rb, Gs^Fms, Gs^Es, Rb, Gs^Fds, Wo, Ww, Wo^Bp/, Cer, Wo, Wo, Rb, Gs^Fds, Gd^Efm, Ss, Gs^Fms, Gs^Es, Mm, Mm, Gs^Fds, Rb, Gs^Fms, Gs^Fds, Gs^Gvs, Gs^Fms, Gs^Fds, Gs^Fms
Gs^Fms, Gs^Fms, Gs^Fms, Wo, Wo, Gs^Fds, Gs^Efm, Gs^Fds, Gs^Fms, Wo, Gs^Fms, Re, Gs^Fms, Ww, Gs^Fms, Gs^Fms, Gs^Fds, Gs, Gs^Fms, Gs^Fds, Mm, Gs^Fds, Gs^Es, Gs^Fms, Gs^Fds, Rb, Gs^Fms, Gd^Gvs, Wo, Wo, Wo, Wo
Gs, Gs^Fds, Gs^Es, Mm, Gs^Fds, Gll, Gs, Gs, Wo, Ww, Gs^Es, Rb, Gs, Gs^Fms, Gs^Es, Gs^Fds, Ss, Gs, Gs^Es, Mm, Wo, Mm, Mm, Gs^Fms, Rb, Rb, Re^Es, Rb^Vo, Wo, Wo, Wo, Wo
Gs^Fms, Gs^Es, Gs^Fds, Gs^Fms, Ss, Gs, Gs^Fms, Wo, Gs^Fms, Gs^Fms, Gs^Es, Rb, Rb, Gs^Fms, Gs^Fds, Gs, Gs^Es, Gs^Fds, Mm, Mm, Rb^Vo, Wo, Mm, Gs^Fds, Rb, Gs^Fds, Mm, Wo, Wo, Wo, Wo, Wo
Rb, Gs^Fms, Gs^Efm, Gs^Fds, Gs^Fms, Gs^Fms, Ww, Wo, Gs^Fms, Gs^Fds, Gs^Fms, Gs^Fds, Rb, Gs^Fms, Rb, Gs^Es, Gs^Fds, Gs^Fms, Mm, Mm, Wo, Wo^Bp\, Rb, Rb, Gd, Gs^Fds, Gs^Fds, Gs^Fms, Wo, Wo, Mm, Mm
Gs^Fms, Rb, Rb, Rb, Rb, Gs^Fds, Wo, Gs^Es, Gs^Fms, Ss, Gs^Fms, Gs^Gvs, Rb^Vo, Rb, Mm, Rb, Rb, Gs^Fds, Ss, Gs^Fms, Ww, Gs^Es, Gs, Gs^Fds, Wo, Gs^Fms, Wo, Wo, Wo, Wo, Gg^Fds, Mm
Gd, Gs^Fds, Gs^Es, Gs^Fds, Rb, Gs^Fms, Gs^Es, Wo, Ww, Gll, Gs^Fds, Gs, Gd^Efm, Mm, Mm, Gs^Es, Rb, Gs^Fms, Gs^Fms, Gs^Fds, Gg^Efm, Ww, Wo, Wo, Gs^Fms, Wo, Wo, Wo, Wo, Mm, Ww^Ewf, Mm
Gs^Fds, Gs^Es, Rb, Rb, Gs^Es, Gs^Fds, Gs^Efm, Gs^Fds, Ww, Gs^Fms, Gs^Fms, Gs^Fms, Gs^Fms, Gs^Fds, Gs^Fms, Gs^Fms, 2 Re, Re, Ce, Gs^Fds, Mm, Gs^Fds, Gs^Fds, Gs^Fds, Gs^Fds, Wo, Wo, Wo, Wo, Chr, Wo, Wo
Gs^Fms, Gs^Fds, Rb^Es, Rb^Vo, Wo, Gs^Fms, Wo, Gs^Fms, Gs^Fds, Wo, Wo, Gs^Efm, Gs^Fms, Ss, Gs^Fms, Gs^Fms, Re^Vct, Ce, 1 Ke, Wo^Edt, Wo^Edt, Mm, Gd, Mm, Gs^Fds, Gll, Wo, Wo, Wo, Wo, Gg^Fds, Gg^Fds
Wo, Gs^Fms, Wo, Wo, Wo, Wo, Wo, Gs^Fms, Gs, Gs^Fms, Wo, Gs^Fms, Wo, Gs^Fms, Gd, Mm, Gs^Fms, Ww^Ewl, Wo, Wo, Wo, Gs^Fds, Gs^Fms, Wo, Wo, Wo, Wo, Wo, Wo, Mm, Mm, Gg^Fds
Wo, Wo, Wo, Wo, Wo, Wo, Wo, Wo, Wo, Gs^Fds, Wo, Wo, Wo, Wo, Gs^Fms, Mm, Mm, Gs^Fms, Wo, Wo, Gs^Fds, Mm, Wo, Wo, Wo, Wo, Wo, Wo, Mm, Mm, Mm, Mm
Wo, Wo, Mm, Wo, Mm, Wo, Wo, Mm, Wo, Wo, Wo, Wo, Wo, Wo, Wo, Mm, Mm, Wo, Wo, Wo, Wo, Wo, Wo, Wo, Wo, Mm, Mm, Wo, Wo, Mm, Mm, Gg^Fds
Mm, Wo, Mm, Mm, Wo, Wo, Wo, Wo, Wo, Wo, Wo, Wo, Wo, Wo, Wo, Wo, Wo, Wo, Wo, Wo, Wo, Wo, Wo, Wo, Wo, Wo, Mm, Mm, Mm, Mm, Mm, Gg^Fds
Mm, Mm, Mm, Mm, Mm, Mm, Mm, Wo, Chr, Gg^Fds, Mm, Mm, Mm, Wo, Wo, Wo, Wo, Wo, Mm, Wo, Gg^Fds, Wo, Wo, Wo, Gg^Fds, Mm, Mm, Mm, Mm, Mm, Mm, Mm
Mm, Mm, Mm, Mm, Mm, Mm, Wo, Wo, Mm, Mm, Mm, Mm, Mm, Wo, Wo, Wo, Wo, Wo, Mm, Mm, Mm, Mm, Gg^Fds, Chr, Gg^Fds, Mm, Mm, Mm, Mm, Mm, Mm, Mm
Mm, Mm, Mm, Mm, Wo, Mm, Wo, Mm, Mm, Mm, Mm, Mm, Mm, Mm, Wo, Wo, Wo^Bp\, Gg^Fds, Gg^Fds, Mm, Mm, Mm, Mm, Mm, Mm, Wo, Mm, Mm, Mm, Gg^Fds, Gg^Fds, Mm
Gg, Mm, Mm, Mm, Mm, Wo, Mm, Mm, Mm, Mm, Mm, Mm, Mm, Gg^Fds, Chr, Wo, Mm, Gd, Mm, Mm, Mm, Mm, Mm, Mm, Mm, Mm, Mm, Mm, Mm, Mm, Mm, Mm
Gg, Mm, Gg, Mm, Mm, Mm, Mm, Mm, Mm, Mm, Mm, Mm, Gg, Gs^Fds, Wo, Wo, Gg, Gd, Mm, Mm, Gg, Gg, Gg, Gg, Mm, Mm, Mm, Mm, Mm, Mm, Mm, Mm
