Ai, Ai, Wog, Wog, Wog, Wog, Wog, Wog, Wog, Ai, Ai, Ai, Wog, Wog, Ai, Ai, Ai, Wog, Ai, Ai, Ai, Ai, Wog, Wog, Wog, Wog, Wog, Wog, Wog, Wog, Wog, Wog
Ai, Ai, Ai, Wog, Wog, Wog, Ai, Wog, Ai, Ai, Ai, Wog, Ai, Wog, Ai, Wog, Wog, Wog, Aa^Vca, Aa^Esa, Ai, Wog, Ai, Ai, Wog, Wog, Wog, Wog, Ai, Wog, Wog, Ai
Ai, Ai, Ai, Wog, Ai, Ai, Ai, Ai, Ai, Ai, Ai, Aa^Vca, Aa, Ai, Aa^Fpa, Ai, 2 Kea, Cea, Re, Aa, Cea, Ai, Aa^Fpa, Ms^Xm, Ai, Wog, Ai, Ai, Wog, Wog, Ai, Ai
Ai, Ai, Ai, Ai, Ai, Ai, Wog, Ai, Ai, Ai, Ai, Aa^Esa, Aa, Ai, Ai, Wog, Cea, Cea, Aa, Cea, 1 Kea, Wog^Esa, Wog, Aa^Fpa, Ai, Ai, Ai, Ai, Wog, Wog, Ai, Ai
Aa^Fpa, Ai, Aa^Vca, Ai, Ai^Bw/, Wog^Esa, Ai, Ai, Ai, Ai, Ai, Ai, Ai, Aa, Aa, Aa^Esa, Aa^Fpa, Aa, Aa^Vca, Cea, Cea, Aa^Vca, Aa, Ai, Ai, Ai, Ai, Ai, Ai, Ai, Ai, Ai
Aa^Fpa, Aa^Fpa, Rb, Ai^Bw/, Ai, Ai, Aa^Fpa, Ms, Aa^Vca, Wog^Esa, Ai, Ai, Ai, Aa^Esa, Aa, Aa^Fpa, Wwg, Aa, Aa^Esa, Wwg, Rb, Aa, Aa^Esa, Ai, Ai, Ai, Aa, Ai, Wog, Ai, Ai^Esa, Aa^Fpa
Aa^Fpa, Rb, Rb^Es, Aa^Fpa, Ai, Ai, Aa, Aa^Fpa, Aa^Esa, Ai, Ai, Ai, Ai^Esa, Ai, Aa, Wwg, Aa, Aa, Re, Aa^Fpa, Aa, Aa, Ai, Ai^Esa, Ai, Ms, Aa^Esa, Aa^Vca, Aa, Aa^Esa, Ms, Aa^Fpa
Ms, Aa^Fpa, Aa, Ms^Xm, Aa^Fpa, Aa^Fpa, Rb, Aa^Fpa, Ms, Ai^Esa, Ai, Aa^Fpa, Aa, Ai, Aa, Aa, Aa^Fpa, Aa^Fpa, Ms, Gg, Rb, Ms, Aa^Fpa, Ai^Esa, Aa^Fpa, Aa, Aa^Fpa, Rb, Rb, Aa, Aa^Fpa, Aa^Fpa
Ms, Aa^Fpa, Gg, Ms, Gg, Gg^Efm, Aa^Fpa, Rb^Es, Aa^Fpa, Aa^Fpa, Aa^Esa, Aa, Aa^Fpa, Aa, Aa, Aa^Esa, Ms, Aa^Fpa, Aa^Fpa, Wwg, Gg, Aa^Fpa, Aa, Aa, Aa, Aa, Aa^Fpa, Aa^Fpa, Aa, Aa^Fpa, Aa^Vca, Aa^Fpa
Ms, Ms, Aa^Fpa, Aa^Fpa, Aa, Aa^Fpa, Aa^Fpa, Gg^Es, Wwg, Aa^Fpa, Aa, Aa^Fpa, Ms^Xm, Ms^Xm, Aa^Fpa, Gg, Gg^Es, Cea, Aa^Vca, Gg, Ms^Xm, Gg^Es, Aa, Aa^Esa, Aa^Fpa, Gg, Aa, Ms, Aa, Wog, Aa, Ms
Ms, Wwg, Aa^Esa, Gg^Efm, Gg, Ms, Ms^Xm, Aa, Aa, Aa, Aa, Aa^Esa, Aa^Esa, Wwg, Cea, Aa^Fpa, Aa^Fpa, Aa, Aa^Fpa, Aa^Esa, Gg, Ms, Wwg, Aa, Re, Gg^Fp, Re, Gg, Gg^Fp, Gg^Efm, Wog, Wog
Aa, Aa^Fpa, Aa, Aa^Fpa, Gg^Es, Wog, Gg^Vc, Rb^Esa, Aa^Esa, Aa, Gg^Fp, Rb, Aa^Fpa, Gg^Efm, Aa^Vca, Aa^Fpa, Wwg^Es, Wwg, Aa^Fpa, Aa^Fpa, Rb, Gg^Es, Aa^Fpa, Aa, Gg^Fp, Re, Gg^Fp, Re, Gg^Fp, Gg^Fp, Re, Rd
Aa^Fpa, Aa, Aa, Gg, Aa, Aa^Fpa, Aa^Fpa, Aa^Fpa, Aa^Fpa, Gg, Gg, Gg^Es, Aa^Esa, Aa, Aa^Es, Aa^Fpa, Aa, Aa^Esa, Cea, Ms, Ms^Xm, Aa^Vca, Aa, Aa^Fpa, Aa, Gg^Es, Re, Rd, Rd, Re, Gg^Fp, Gg^Fp
Aa, Aa^Esa, Coa, Rb, Aa, Aa^Fpa, Rb, Rb, Aa^Esa, Gg^Efm, Aa, Gg, Gg, Aa, Gg, Ms, Gg^Es, Aa^Vca, Wwg, Aa^Fpa, Aa^Fpa, Gg^Efm, Wwg, Wwg, Aa^Fpa, Rd, Gg^Fp, Gg^Fp, Gg, Gg^Es, Gg^Fp, Gg^Fp
Ms, Aa^Fpa, 3 Koa, Coa, Aa, Aa^Fpa, Rb, Aa^Vca, Wwg, Aa^Esa, Aa^Fpa, Aa, Gg, Gg^Fp, Gg^Es, Aa, Aa^Fpa, Aa^Fpa, Aa^Esa, Aa^Fpa, Gg, Aa^Fpa, Aa^Fpa, Gg^Es, Aa^Fpa, Rd, Gg^Es, Gg^Fp, Gg^Efm, Gg, Gg^Vc, Gg^Fp
Aa^Fpa, Wwg, Coa, Coa, Aa^Fpa, Aa, Gg, Wwg, Ms, Aa, Gg, Gg, Gg^Fp, Gg, Wog, Wog, Ai, Ms^Xm, Ms, Gg^Es, Aa^Fpa, Ms, Gg, Aa^Fpa, Gg^Es, Re, Aa^Fpa, Aa^Fpa, Aa^Fpa, Wog, Aa^Esa, Aa^Fpa
Ms, Aa^Fpa, Aa^Fpa, Aa^Vca, Aa^Fpa, Gg^Fp, Gg^Efm, Gg^Fp, Gg^Es, Gg, Gg^Fp, Gg^Fp, Aa^Esa, Gg^Efm, Wog, Wog, Wog, Wog, Ai, Aa, Aa^Fpa, Ms^Xm, Wog, Gg, Gg^Es, Re, Co, Wwg, Aa^Fpa, Ms, Aa, Aa
Ms, Ms, Aa^Fpa, Aa^Esa, Aa, Aa^Esa, Re^Es, Gg^Fp, Gg^Fp, Gg, Gg^Fp, Gg^Fp, Re, Aa, Wog^Bw/, Aa^Fpa, Wog, Wog, Wog, Aa^Fpa, Gg^Efm, Aa^Fpa, Aa^Esa, Aa^Fpa, Aa^Fpa, Rd, 4 Ko, Co, Gg^Es, Gg^Es, Aa^Fpa, Aa^Fpa
Aa^Fpa, Ms, Aa^Esa, Ms, Aa, Aa^Fpa, Aa^Esa, Rd, Re^Es, Re, Re^Es, Re^Es, Gg^Fp, Rd, Aa^Vca, Wog, Ai, Wog, Wog, Gg^Vc, Gg^Fp, Aa, Aa, Aa^Fpa, Gg^Vc, Co, Co, Wog, Gg^Fp, Rb, Gg^Fp, Aa^Fpa
Aa^Fpa, Aa^Fpa, Aa, Aa, Aa^Fpa, Aa^Fpa, Aa, Ms, Aa, Ms, Gg, Gg^Fp, Gg, Gg^Fp, Gg, Aa, Gg^Fp, Wog, Gg^Fp, Gg, Gg^Fp, Aa, Gg, Gg^Es, Gg, Wog, Gg, Rb, Gg^Fp, Gg^Fp, Gg^Fp, Gg^Fp
