Aa, Ai, Ai, Ai, Ai, Wog, Wog, Wog, Wog, Wog, Wog, Wog, Wog, Wog, Wog, Wog, Wog, Wog, Wog, Wog, Wog, Wog, Wog, Wog, Wog, Wog, Wog, Wog, Wog, Ai, Ai, Wog
Aa^Fpa, Aa^Fpa, Aa^Fpa, Ai, Ai, Wog^Esa, Wog, Wog, Wog, Wog^Esa, Wog, Wog, Wog, Wog, Wog, Wog, Wog, Wog, Wog, Ai, Ai, Wog, Wog, Wog, Wog, Wog^Esa, Ai, Ai, Ai, Ai, Ai, Ai
Aa, Aa^Fpa, Aa, Ai, Ai, Wog, Ai, Wog^Esa, Wog, Wog, Wog, Wog, Wog, Wog^Esa, Ai, Wog, Wog, Wog, Wog, Wog^Esa, Ai, Wog, Wog, Ai, Ai, Wog, Wog, Ai, Ai, Ai, Ai, Ai
Aa^Fpa, Aa^Fpa, Ai, Ai, Ai, Ai, Ai, Ai, Wog, Wog, Wog^Esa, Wog, Wog, Wog, Wog, Wog, Wog, Wog, Wog, Wog, Wog, Wog, Wog, Wog, Ai, Ai, Ai, Ai, Ai, Ai, Ai, Ai
Aa^Fpa, Aa, Wog, Ai, Aa, Ai, Ai, Ai, Ai, Ai, Ai, Wog^Esa, Wog, Wog, Ai, Wog, Wog, Wog, Ai, Wog, Wog, Wog^Esa, Ai, Wog, Wog, Ai, Aa^Esa, Ai, Ai, Ms, Ms, Ai
Rb, Aa^Fpa, Aa, Aa, Aa^TcsZ, Aa, Ai, Wog, Ai, Ai, Ai, Wog, Wog, Wog^Esa, Ai, Ai, Ai, Wog, Wog, Ai, Ai, Wog, Ai, Ai, Ai, Ai, Aa^Fpa, Aa^Fpa, Ms, Aa^Fpa, Ms, Ms
Aa^Fpa, Rb, Cea, Aa^Fpa, Aa, Aa^TcsZ, Ai, Ai, Ai, Ai, Ai, Wog, Ai, Ai, Ai, Ai, Wog, Wog, Wog, Ai, Ai, Ai, Wog, Ai, Ai, Ai, Aa^Fpa, Ms, Cea, Ms, Aa^Tvvs, Ms
Aa^Fpa, Cea, 1 Kea, Cea, Aa, Aa^TcsZ, Ai, Aa^Fpa, Aa, Ai, Ai, Ai, Ai, Ai, Ai, Wog^Esa, Wog, Wog, Ai, Ai, Ai, Aa^Tvvs, Aa, Ai, Ai, Ai, Wog, Cea, 3 Kea, Cea, Ms, Aa
Aa^Fpa, Cea, 2 Rb, Aa^Fpa, Aa^Fpa, Aa^TcsZ, Ai, Aa^Fpa, Aa^Esa, Aa^Tvvs, Ai, Ai, Ai, Ai, Ai, Ai, Wog^Esa, Wog, Ai, Ai, Ai, Aa, Ai, Aa, Aa, Ai, Aa^Tvvs, Cea, Rb, Cea, Aa^Fpa, Ms
Aa^Fpa, Aa, Rb, Aa^Fpa, Aa, Ai, Ai, Ai, Aa^Fpa, Ai, Ai, Ai, Ai, Ai, Ai, Ai, Ai, Ai, Ai, Ai, Ai, Ai, Wog, Aa^Fpa, Aa^Fpa, Aa^Fpa, Aa, Aa, Rb, Aa^Fpa, Aa^Fpa, Ms
Aa^Esa, Aa^Fpa, Aa, Rb, Aa^Fpa, Ai, Aa, Aa^Fpa, Ai, Ai, Ai, Aa^TcsZ, Aa^TcsZ, Ai, Ai, Ai, Ai, Ai, Ai, Ai, Aa^TcnZ, Aa^Fpa, Ai^Esa, Ai^Esa, Aa, Aa, Rb, Rb, Aa^Fpa, Aa^Fpa, Ms, Ms
Aa^Fpa, Aa^Tvvs, Rb, Rb, Aa^Fpa, Aa, Aa, Aa^Fpa, Ai^Esa, Ai, Aa^Fpa, Aa^Tvvs, Aa^TcsZ, Ai, Ai, Ai, Ai, Ai, Ai, Ai, Aa^TcnZ, Aa, Aa, Aa, Aa^Esa, Aa, Rb, Aa^Esa, Aa, Aa, Aa, Ms
Aa^Fpa, Aa^Esa, Rb, Aa^Fpa, Rb, Rb, Rb, Aa, Aa^Fpa, Aa, Aa^Fpa, Aa^TcsZ, Ai, Ai, Ww, Ai, Ai, Ai, Ai, Ai, Aa^TcnZ, Aa^Fpa, Aa, Aa^Fpa, Rb, Rb, Aa^Fpa, Aa, Aa^Fpa, Ms, Ww, Aa
Aa, Aa, Aa^Fpa, Rb, Aa^Fpa, Aa^Fpa, Aa, Rb, Rb, Rb, Rb, Aa^TcsZ, Ai, Ww, Aa^Fpa, Aa, Aa^Fpa, Ai, Ww, Aa^TcnZ, Aa, Aa^Tvvs, Rb, Rb, Rb, Aa^Fpa, Aa^Esa, Aa^Tvvs, Ms, Ms, Ms, Aa^Fpa
Aa^Fpa, Wwf, Aa, Rb, Aa^Esa, Aa^Fpa, Aa^Fpa, Aa^TcsZ, Rb, Aa^Fpa, Rb^Es, Rb, Ww^Bw\, Ww, Aa^Fpa, Aa^Esa, Aa, Ww, Aa^Tvvs, Aa^TcnZ, Rb, Rb, Aa^Esa, Aa^Fpa, Rb, Aa^Fpa, Ww, Aa^Fpa, Ms, Ms, Aa, Aa
Aa, Aa^Tvvs, Aa^Fpa, Rb, Aa^Fpa, Ww, Aa^TcsZ, Aa^TcsZ, Rb, Aa^Tvvs, Ww, Aa^Fpa, Ww, Rb, Rb^Es, Cea, Kea, Ww, Aa^Fpa, Aa, Rb, Aa, Aa^Fpa, Aa^Fpa, Rb, Aa^Fpa, Aa, Aa^Fpa, Aa, Aa^Fpa, Aa, Ha
Aa^Fpa, Aa^Fpa, Aa, Rb, Rb, Rb, Aa^TcsZ, Aa^Fpa, Ww, Ww^Bw\, Rb^Es, Ai, Aa^Esa, Aa^Fpa, Aa^Fpa, Cea, Aa, Ww^Bw\, Rb, Rb, Aa^Esa, Rb, Rb, Rb, Rb, Rb, Ms, Ms, Aa, Aa^Esa, Aa^Tvvs, Ms
Aa^Fpa, Aa^Fpa, Aa, Aa^Fpa, Aa, Rb, Ww^Bw\, Ww, Aa^Fpa, Aa^Fpa, Aa^Fpa, Rb^Es, Rb^Es, Rb^Es, Rb^Es, Aa^Esa, Ww, Ww, Aa^Tvvs, Aa^Fpa, Aa^TcnZ, Rb, Aa^Fpa, Aa^Fpa, Rb, Aa^Fpa, Ms, Ms, Rb, Rb, Rb, Ms
Aa^Fpa, Aa^Esa, Aa^TcsZ, Aa^TcsZ, Aa^Fpa, Aa^Esa, Ai, Rb, Rb, Wwf, Aa^Fpa, Aa^Tvvs, Aa^Fpa, Aa^Fpa, Aa, Ww^Bw\, Rb^Es, Aa, Aa^TcnZ, Aa^TcnZ, Aa^Fpa, Rb, Aa, Aa, Ms^Xm, Rb, Rb^Es, Aa^Fpa, Rb, Aa^Fpa, Aa^Fpa, Rb
Rb, Aa, Aa^TcsZ, Aa, Aa^Fpa, Ww, Aa^TcnZ, Aa^TcnZ, Rb, Aa^TcsZ, Aa^TcsZ, Rb^Es, Rb^Es, Aa, Aa^Esa, Ww, Aa, Rb^Es, Aa^TcnZ, Aa^Tvvs, Rb, Aa, Ms, Aa^Fpa, Aa^Esa, Ms^Xm, Aa^Tvvs, Rb, Aa, Aa, Ha, Aa
Aa^Fpa, Aa^Fpa, Aa^TcsZ, Aa, Ww, Ww, Aa^TcnZ, Aa^Tvvs, Aa^Fpa, Aa^Fpa, Aa^TcsZ, Aa^Fpa, Aa^Fpa, Aa^Fpa, Ww, Ww, Aa^Fpa, Rb^Es, Aa^Fpa, Rb, Ha, Ha, Ms^Xm, Aa^Fpa, Ha, Aa, Aa, Aa^Esa, Ha, Ms, Ms, Ms
Aa, Aa^TcsZ, Ms, Ww, Aa^TcnZ, Aa^TcnZ, Aa^Fpa, Aa, Aa^Fpa, Aa^Fpa, Aa^TcsZ, Aa^Fpa, Ww, Ww, Aa, Aa^Fpa, Aa, Rb^Es, Aa, Gg, Aa, Ms, Ms^Xm, Ms^Xm, Ms, Aa, Ms, Aa, Ms, Ms, Ms, Ms
