Ai, Ai, Ai, Ai, Ai, Aa, Aa^Fpa, Aa^Fpa, Aa, Ai, Ai, Ai, Ai, Wog, Ai, Wog, Wog, Wog, Wog, Wog, Wog, Wog, Ai, Ai, Ai, Ai, Ai, Wog, Wog, Ai, Ai, Ai
Aa^Fpa, Aa^Fpa, Ai, Ai, Aa, Aa, Ms, Aa^Fpa, Aa, Aa, Ai, Ai, Ai, Ai, Ai, Wog, Ai, Wog, Ai, Ai, Wog, Ai, Ai, Ai, Ai, Ai, Ai, Ai, Ai, Ai, Aa^Fpa, Ai
Aa^Fpa, Ai, Ai, Ai, Aa, Ms, Ww, Aa, Aa^Fpa, Ai, Ai, Ai, Aa^Fpa, Aa^Fpa, Ai, Ai, Wog, Wog, Ai, Ai, Ai, Ai, Wog, Ai, Aa^Vca, Aa^Fpa, Aa, Aa^Fpa, Ai, Ai, Aa^Fpa, Aa
Aa^Esa, Wog, Aa, Aa, Aa^Fpa, Aa, Aa, Aa^Fpa, Ai, Ai, Aa^Esa, Ai, Aa^Fpa, Aa^Vca, Ai, Ai^Esa, Ai, Ai, Ai, Ai, Aa^Fpa, Aa, Ai^Esa, Ai^Esa, Aa, Aa, Aa^Fpa, Aa^Fpa, Aa, Aa^Esa, Rb, Ms
Aa^Fpa, Aa^Vca, Cea, Aa^Fpa, Aa^Fpa, Aa, Aa, Aa^Fpa, Ai^Esa, Ai, Aa, Aa^Esa, Ms, Aa^Fpa, Aa, Ai, Ai, Ai, Ai, Aa^Vca, Aa^Fpa, Aa^Fpa, Aa, Aa, Ms, Aa, Aa, Aa^Esa, Aa, Aa, Aa^Fpa, Ms
Aa^Fpa, Cea, 1 Kea, Cea, Aa, Aa^Esa, Aa^Esa, Aa, Aa^Fpa, Aa, Aa, Ms, Aa, Aa^Fpa, Aa, Aa, Ai, Ai, Aa^Fpa, Aa^Esa, Aa, Aa, Ms, Ms, Ms, Ha, Aa^Fpa, Aa, Aa^Fpa, Ww, Ha, Aa^Fpa
Rb, Cea, Rb, Aa, Aa^Fpa, Aa^Fpa, Aa, Ha, Aa^Fpa, Aa, Ms, Aa, Aa^Fpa, Aa, Ai, Ai, Ai, Aa, Ha, Aa^Fpa, Aa, Ms, Ms^Xm, Aa^Fpa, Aa, Aa^Fpa, Aa^Esa, Aa, Ms, Ms, Ms, Aa^Fpa
Aa^Fpa, 2 Rb, Aa, Rb, Aa, Aa^Fpa, Aa, Aa^Fpa, Ms, Ww, Ms^Xm, Gg, Ha, Ms, Ww, Ww, Aa^Fpa, Aa, Aa^Esa, Aa^Fpa, Rb, Rb, Rb, Rb, Rb, Aa, Aa, Aa^Fpa, Ms, Ms, Aa, Aa
Aa, Aa^Vca, Aa^Fpa, Rb, Aa^Fpa, Aa, Aa, Ms, Ha, Gg^Efm, Aa, Aa^Fpa, Aa^Vca, Ms, Wwf^Es, Aa^Fpa, Gg, Gg^Efm, Aa^Vca, Rb, Aa^Fpa, Aa, Aa^Esa, Aa^Fpa, Aa^Fpa, Rb, Aa, Aa^Fpa, Aa, Aa^Fpa, Aa, Gg
Aa^Fpa, Aa^Fpa, Aa, Rb, Rb, Rb, Rb, Aa^Fpa, Ww, Aa, Wwf^Es, Ww, Ww, Ww, Ms, Aa, Aa^Fpa, Aa^Fpa, Aa^Esa, Rb, Ha, Ms^Xm, Ms^Xm, Aa, Rb, Rb, Aa^Esa, Aa^Fpa, Aa, Aa^Esa, Aa^Vca, Ms
Gg, Aa^Fpa, Aa, Aa^Fpa, Ha, Aa, Aa, Ai, Aa^Vca, Ww, Aa^Fpa, Aa^Fpa, Ai, Aa, Rb, Ms^Xm, Rb, Aa^Fpa, Rb, Rb, Aa, Ms, Aa^Fpa, Aa^Fpa, Rb, Aa^Fpa, Aa, Aa, Rb, Rb, Rb, Ms
Aa^Fpa, Aa, Aa^Fpa, Aa^Fpa, Aa, Aa^Esa, Ww, Wwf^Es, Aa^Fpa, Ai, Ww, Ww, Aa^Fpa, Rb^Es, Aa^Fpa, Rb, Ms, Rb, Aa^Fpa, Aa^Fpa, Ms, Aa, Gg, Cea, 3 Kea, Cea, Rb^Es, Aa^Fpa, Rb, Aa^Fpa, Aa^Fpa, Rb
Gg^Fp, Gg, Gg, Aa, Gg, Ms, Ms, Ww, Wwf^Es, Ww, Ms^Efm, Ha, Aa^Esa, Aa^Fpa, Ww, Aa^Vca, Ms^Xm, Aa, Ww, Ww, Aa, Aa, Ms, Cea, Aa^Fpa, Cea, Aa^Vca, Rb, Aa, Aa, Ha, Aa
Gg^Fp, Gg^Fp, Aa^Fpa, Ww, Ms, Gg, Aa^Vca, Ai, Aa, Aa^Fpa, Gg^Efm, Gg, Aa, Ww, Aa^Fpa, Ha, Ms, Aa^Fpa, Aa^Fpa, Aa^Esa, Aa, Ms, Ms^Xm, Aa^Fpa, Gg^Efm, Gg, Aa, Aa^Esa, Aa, Ms, Ms, Ms
Aa, Aa^Fpa, Ms, Ms, Ms, Ms, Ww, Ww, Ms, Ms, Ms, Ms, Ms, Ms, Rb, Ms, Ms, Ms, Aa, Gg, Aa, Ms, Ms^Xm, Ms^Xm, Ms, Gg, Ms, Gg, Ms, Ms, Ms, Ms
