Ms, Ms, Aa, Aa^Fpa, Aa^Fpa, Aa^Fpa, Aa, Aa^Fpa, Aa^Fpa, Gg, Ms, Ms, Aa, Ql, Ql, Re, Aa^Fpa, Ms, Ms, Aa, Ms, Mm, Ms^Xm, Mm, Ms^Xm, Mm, Ms^Xm, Mm, Mv, Gg, Ms^Xm, Gg
Aa, Ms, Re, Aa, Rb, Wwg, Gd, Re, Gll^Fp, Gd, Aa, Ms, Aa, Ql, Rr^Vd, Rd, Aa, Ms, Ms, Ms, Aa^Fpa, Ms^Xm, Mv, Rr^Vd, Wwg, Cte, 3 Kte, Mm, Mm, Mm, Ms^Xm, Ms^Xm
Aa, Re, Ms, Aa, Ql, Rr^Vd, Gg, Gll^Fp, Aa, Aa^Fpa, Wwg, Gs, Gll^Fp, Gg, Gd, Re, Re, Ms, Ms, Ms, Aa, Mm, Mm, Mm, Cte, Cte, Ql, Rr^Vd, Wwg, Ms, Ms, Ms
Aa^Fpa, Aa^Fpa, Ms^Xm, Ms, Ql, Rd, Re, Re, Rb, Aa^Fpa, Re, Rb, Re, Gs, Rb, Aa, Rb, Aa^Fpa, Ms, Ms, Aa, Gd, Re, Cte, Gd, Cte, Mm, Mv, Mm, Ms^Xm, Ms^Xm, Ms
Aa, Aa^Vca, Re, Aa, Aa^Fpa, Aa, Gs, Aa, Gs, Rd, Aa, Aa, Aa^Fpa, Re, Aa, Rb, Aa^Fpa, Gd, Aa, Aa, Rr^Vd, Aa, Re, Gs, Gs, Cte, Cte, Mm, Ms, Ms^Xm, Ms^Xm, Ms^Xm
Aa^Fpa, Aa, Aa, Re, Aa, Gs, Re, Gll^Fp, Gs, Aa, Gg, Aa, Gd, Aa^Fpa, Re, Rb, Re, Aa^Fpa, Aa, Ql, Ql^Bs/, Rd, Re, Re, Aa^Fpa, Re, Gs, Rr^Vd, Ms, Ms^Xm, Ms^Xm, Ms^Xm
Aa^Fpa, Gs, Re, Re, Gs, Re, Aa, Gll^Fp, Ai, Wwg, Aa, Ms, Rr^Vd, Rd, Md, Gg, Aa, Re, Re, Rd, Aa, Ql, Re, Gd, Aa, Rd, Rd, Aa^Fpa, Aa^Fpa, Ms, Ms, Ms
Aa, Gg, Re, Aa, Aa^Fpa, Aa^Fpa, Gd, Aa^Fpa, Ms, Gd, Gs, Aa^Fpa, Ql, Ql, Md, Md, Aa^Fpa, Aa^Fpa, Re, Aa, Aa, Ql, Re, Gd, Gg, Gs, Aa, Aa, Gg, Wwg, Md, Ms
Aa, Re, Aa^Vca, Aa, Gd, Aa^Fpa, Gd, Ms, Ms, Aa^Fpa, Ms, Aa, Gd, Gs, Gg, Aa, Re, Re, Ms^Xm, Re, Re, Gd, Aa^Fpa, Re, Re, Aa, Gs, Aa^Fpa, Aa^Fpa, Re, Gs, Ms
Aa, Re, Re, Re, Re, Aa, Aa^Fpa, Ms, Ms, Ms, Gg, Aa, Aa^Fpa, Rb, Aa^Fpa, Aa^Fpa, Wwg, Re, Gg, Rr^Vd, Ql, Gll^Fp, Aa^Fpa, Aa, Re, Aa, Gd, Aa^Fpa, Ms, Gs, Md, Ms
Aa^Fpa, Gd, Gd, Aa^Fpa, Re, Aa^Fpa, Wwg, Aa^Fpa, Ms, Gd, Rb, Gll^Fp, Gd, Rb, Aa^Fpa, Ql, Rr^Vd, Rb, Gd, Gg, Ms, Wwg, Aa, Aa, Re, Ms, Ms^Xm, Rr^Vd, Ql, Gd, Md^Xm, Ms
Aa^Fpa, Wwg, Aa, Aa, Re, Aa, Aa, Aa^Vca, Rd, Gd, Rb, Rd, Rd, Gg, Aa, Gd, Re, Re, Aa, Aa^Fpa, Ms, Aa, Aa, Rd, Ms^Xm, Ms^Xm, Ms, Ql, Aa^Fpa, Ql, Aa, Md^Xm
Aa^Fpa, Aa^Fpa, Re, Re, Aa^Vca, Aa, Aa^Fpa, Re, Rd, Aa, Aa, Aa, Re, Re, Re, Re, Re, Aa, Aa^Vca, Ms, Aa, Aa, Ql, Rr^Vd, Re, Re, Re, Aa^Fpa, Re, Re, Aa, Aa^Fpa
Aa^Fpa, Re, Aa^Fpa, Aa^Fpa, Ms, Ms, Aa^Fpa, Re, Re, Re, Re, Re, Aa^Vca, Aa^Fpa, Aa, Gd, Aa, Aa^Fpa, Aa, Aa, Aa^Fpa, Aa^Fpa, Re, Gll, Aa, Aa, Aa, Re, Wwg, Gll^Fp, Gll^Fp, Aa^Fpa
Aa^Fpa, Re, Gd, Aa^Fpa, Ms, Aa^Fpa, Gd, Re, Gd, Aa^Fpa, Aa, Aa, Aa^Fpa, Aa, Gs, Gd, Aa^Fpa, Aa^Fpa, Wwg, Aa, Aa^Fpa, Re, Gd, Gg, Ms, Aa, Ql, Rd, Gd, Wwg, Re, Aa
Aa, Re, Re, Gd, Aa, Aa, Re, Re, Aa^Fpa, Aa, Aa, Aa^Fpa, Aa^Fpa, Aa, Re, Aa, Aa^Fpa, Wwg, Wwg, Aa^Fpa, Aa, Aa^Fpa, Gs, Aa^Fpa, Ms, Ms^Xm, Ql, Rr^Vd, Ql, Rd, Aa^Fpa, Aa
Aa^Fpa, Aa^Fpa, Aa^Fpa, Cea, 1 Kea, Rd, Aa^Fpa, Rd, Ms, Ms, Gd, Aa^Fpa, Re, Re, Aa^Fpa, Re, Aa^Vca, Ai, Wwg, Wwg, Aa^Fpa, Wwg, Gg, Aa^Fpa, Aa^Vca, Ms^Xm, Re, Ql, Re, Aa, Aa, Aa^Fpa
Aa^Fpa, Aa^Fpa, Aa^Vca, Cea, Wwg, Cea, 2 Cea, Cea, Aa^Vca, Aa, Re, Aa, Re, Aa^Fpa, Aa, Re, Re, Aa^Fpa, Aa, Ms, Re, Rd, Re, Re, Re, Re, Aa, Re, Aa^Fpa, Re, Aa^Fpa, Aa^Fpa
Aa, Aa, Aa^Fpa, Aa^Fpa, Aa^Fpa, Cea, Aa^Fpa, Re, Re, Re, Aa^Fpa, Re, Aa^Fpa, Aa, Wwg, Aa^Fpa, Aa, Re, Re, Re, Aa, Aa, Aa, Aa^Fpa, Gll^Fp, Gd, Aa, Aa^Fpa, Aa^Fpa, Re, Aa^Vca, Aa^Fpa
Aa, Aa, Aa^Fpa, Aa^Fpa, Aa, Aa, Aa^Fpa, Aa^Fpa, Aa, Aa, Aa^Fpa, Aa^Fpa, Aa^Fpa, Ms, Ms, Ms, Aa, Ms, Aa, Ms, Aa, Aa, Aa, Aa^Fpa, Aa, Aa, Aa, Aa^Fpa, Aa, Aa^Fpa, Aa^Fpa, Aa^Fpa
