Xu, Xu, Xu, Xu, Xu, Xu, Xu, Xu, Xu, Xu, Uu, Tb^Tf, Uu, Uh, Ql, Xu, Uh, Xu, Xu, Xu, Xu, Xu, Xu, Xu, Xu, Xu, Xu, Xu, Xu, Xu, Xu, Xu, Xu, Xu, Ur^Br|, Xu, Xu
Xu, Xu, Xu, Xu, Xu, Xu, Xu, Xu, Xu, Xu, Xu, Uh, Uh, Uh, Uh, Ql, Xu, Uu, Ql, Xu, Xu, Xu, Xu, Cfa, Aa^Fpa, Xu, Xu, Xu, Xu, Xu, Xu, Xu, Ur^Br/, Xu, Ur^Br/, Xu, Xu
Xu, Xu, Xu, Xu, Cfa, Xu, Xu, Xu, Xu, Xu, Xu, Uh, Xu, Xu, Xu, Ql, Ur, Xu, Ql, Tb^Tf, Uh, Xu, Xoa, 8 Kfa, Aa^Esa, Aa^Vaa, Xu, Xu, Xu, Xu, Ur^Br|, Ur^Br/, Xu, Ur^Br\, Xu, Xu, Xu
Xu, Xu, Xu, Xu, Aa^Vaa, 5 Kfa, Aa^Fpa, Xu, Xu, Xu, Uh, Tb^Tf, Xu, Xu, Uh, Uh, Ur^Es, Xu, Xu, Ur, Xu, Xu, Rb, Aa^Esa, Xoa, Xu, Xu, Xu, Ur^Br/, Xu, Ur^Br/, Xu, Xu, Xu, Xu, Xu, Xu
Xu, Xu, Aa^Fpa, Aa^Fpa, Aa^Esa, Aa, Aa^Esa, Xoa, Tb^Tf, Xu, Xu, Ql, Ql, Xu, Ur, Ur, Ur, Ur, Ur^Es, Ur^Es, Ur^Es, Ur, Uh, Rb, Ai, Uh, Ur^Br|, Ur^Br/, Xu, Ur^Br\, Xu, Xu, Xu, Xu, Xu, Xu, Xu
Xu, Xu, Aa^Vaa, Aa^Fpa, Aa, Aa, Xoa, Rb, Ur, Uh, Uh, Uu, Ql, Ur^Es, Ur^Es, Uh, Uh, Uu, Ur^Es, Ur^Es, Uh, Ur, Ur^Es, Xu, Ur, Ur, Ur^Br|, Ai, Xu, Xu, Xu, Xu, Xu, Xu, Xu, Xu, Xu
Xu, Xu, Xu, Aa, Aa^Esa, Xu, Uh, Ur, Uh, Ur^Es, Ur, Xu, Uh, Ur^Es, Ql, Ql, Xu, Uh, Ur, Ur^Es, Uh, Uh, Uu, Uh, Uu, Ur, Ur^Br/, Tb^Tf, Xu, Xu, Xu, Xu, Xu, Xu, Xu, Xu, Xu
Xu, Xu, Xu, Aa, Rb, Xoa, Xu, Ur, Xu, Uu, Uu, Ur^Es, Ur^Es, Ur, Ql, Xu, Xu, Xu, Xu, Ql, Wwg, Xu, Ur^Br/, Tb^Tf, Ur^Br/, Ur^Br|, Uu, Uh, Ur^Es, Xu, Uh, Xu, Xu, Xu, Xu, Xu, Xu
Xu, Xu, Xu, Xoa, Ur, Ur^Es, Xu, Ur^Es, Ur, Uh, Ur, Ur^Es, Uh, Ql, Uu^Vu, Xu, Xu, Xu, Uh, Ql, Ql, Ur^Br/, Xu, Ur^Br\, Xu, Uh, Uu, Ur^Es, Uh, Xu, Uu, Xu, Tb^Tf, Xu, Xu, Xu, Xu
Xu, Xu, Xu, Tb^Tf, Xu, Ur^Es, Tb^Tf, Ur, Uu, Ur^Es, Uu, Cud, 4 Kud, Cud, Xu, Aa, Aa, Xu, Tb^Tf, Ur^Br/, Xu, Xu, Xu, Xu, Xu, Xu, Ur, Ur^Es, Ur, Ur^Es, Ur, Ur, Uu, Uu, Rb, Xoa, Xu
Xu, Xu, Xu, Xu, Xu, Uh, Uh, Ur, Ur, Ur, Uu, Uu^Vu, Xu, Xu, Xu, Aa, Uu, Uu, Uu, Ur^Br|, Uu, Ql, Xu, Xu, Xu, Ur, Xu, Uh, Ur, Uh, Uu, Xu, Xu, Xu, Aa^Fpa, Rb, Xu
Xu, Xu, Xu, Xu, Xu, Xu, Ur^Es, Ur^Es, Uu, Xu, Xu, Xu, Xu, Xu, Uh, Uu, Uh, Ur, Ur^Br/, Ur^Br|, Tb^Tf, Ql, Ql, Xu, Ur^Es, Ur, Ur^Es, Uu, Ur^Es, Uu, Xoa, Xu, Xu, Xu, Aa^Fpa, Aa^Esa, Aa^Fpa
Xu, Xu, Xu, Xu, Xu, Xu, Uu, Ur, Ur, Uu, Xu, Xu, Xu, Xu, Wwg, Tb^Tf, Ur^Br|, Ur^Br/, Uu, Ur, Uu, Xu, Ur, Ur^Es, Uh, Uu, Ur^Es, Ur, Xu, Ur, Rb, Xu, 7 Kfa, Cfa, Aa, Aa^Esa, Aa^Fpa
Xu, Xu, Aa^Fpa, Xu, Xu, Xu, Xu, Uh, Ur^Es, Ur^Es, Ur, Tb^Tf, Uh, Xu, Xu, Uu, Ur^Br|, Uh, Ql, Ql, Ur, Uu, Ur, Uu, Ql, Tb^Tf, Uh, Uu, Xu, Rb, Gg, Gg^Es, Aa, Aa^Esa, Aa^Fpa, Aa^Esa, Xu
Aa^Esa, Aa^Fpa, Aa, Aa^Fpa, Xu, Xu, Xu, Tb^Tf, Ur, Ur, Uu, Ur, Ur, Xu, Xu, Ql, Ql, Uu, Ql, Tb^Tf, Xu, Ur^Es, Uh, Uu, Ql, Xu, Ql, Ql, Xu, Xoa, Wwg, Gg^Es, Aa, Aa^Fpa, Aa^Fpa, Xu, Xu
Aa^Fpa, Aa^Fpa, Aa^Esa, Aa^Esa, Aa^Fpa, Xu, Xu, Xu, Uu, Uh, Uh, Xu, Tb^Tf, Ur^Es, Uh, Ur^Es, Ur^Br|, Ql, Gg, Wwg, Xu, Ur, Uu, Uu, Cud, Xu, Xu, Ql, Xu, Ql, Xu, Aa^Esa, Aa^Vaa, Wog, Xu, Xu, Xu
Rb, Aa, Rb, Aa^Vca, Cea, 2 Aa^Fpa, Aa^Esa, Xoa, Ur, Ur, Xu, Xu, Ur^Br/, Ur^Br/, Ur^Br\, Ur^Br/, Uh, Uh, Xu, Gg, Ur, Ur, Ur^Es, Tb^Tf, Uh, 6 Kud, Uh, Uu^Vu, Ql, Xu, Xu, Xu, Xoa, Xu, Xu, Xu, Xu
Ur, Rb, Aa^Fpa, Rb, Cea, 1 Kea, Rb, Rb, Ur^Es, Ur^Br\, Ur^Br/, Ur^Br/, Ur^Es, Ur, Ur, Uu, Tb^Tf, Xu, Uu, Xu, Ur^Es, Uh, Uu, Uu, Uu^Vu, Cud, Xu, Xu, Uu, Xu, Xu, Xu, Xu, Xu, Xu, Xu, Xu
Aa, Aa^Fpa, Xu, Aa, Wog, Aa^Vca, Xoa, Uu, Ur, Ur^Br/, Ur^Es, Ur, Uu, Uu, Uu, Uh, Uu, Ur, Ur, Uu, Ur^Es, Ur^Es, Xu, Xu, Xu, Xu, Xu, Xu, Ql, Xu, Xu, Xu, Xu, Xu, Xu, Xu, Xu
Aa, Aa^Fpa, Xu, Aa^Fpa, Xu, Xu, Uh, Ur, Tb^Tf, Ur, Uh, Xu, Xu, Uh, Ur^Es, Uh, Uh, Uu, Uh, Ur, Xu, Xu, Xu, Xu, Uu, Xu, Xu, Ql, Ql, Xu, Xu, Xu, Xu, Xu, Xu, Xu, Xu
Xu, Xu, Xu, Xu, Xoa, Xu, Uu, Ur^Es, Uh, Xu, Uu, Xu, Xu, Uh, Uh, Ur, Xu, Xu, Uh, Tb^Tf, Ql, Ql, Xu, Uh, Uu, Xu, Uu, Ql, Xu, Xu, Xu, Xu, Xu, Xu, Xu, Xu, Xu
Xu, Xu, Xu, Aa, Aa^Esa, Ur, Xu, Xu, Xu, Uh, Xu, Xu, Xu, Xu, Ur, Ur, Xu, Xu, Xu, Xu, Xu, Ql, Uh, Xu, Ql, Uh, Xu, Xu, Xu, Xu, Xu, Xu, Xu, Xu, Xu, Xu, Xu
Xu, Xu, Xu, Aa^Fpa, Xu, Xu, Xu, Xu, Xu, Xu, Xu, Xu, Rb, Xoa, Aa^Esa, Xoa, 3 Kud, Xu, Xu, Xu, Xu, Xu, Xu, Ql, Uu, Xu, Xu, Xu, Xu, Xu, Xu, Xu, Xu, Xu, Xu, Xu, Xu
Xu, Xu, Xu, Xu, Xu, Xu, Xu, Xu, Xu, Xu, Xu, Uu^Vu, Rb, Aa^Fpa, Aa, Aa^Esa, Ur, Cud, Xu, Xu, Xu, Xu, Xu, Uu, Xu, Ql, Xu, Xu, Xu, Xu, Xu, Xu, Xu, Xu, Xu, Xu, Xu
Xu, Xu, Xu, Xu, Xu, Xu, Xu, Xu, Xu, Xu, Xu, Xu, Wog, Aa^Esa, Aa^Fpa, Xoa, Xu, Uu^Vu, Xu, Xu, Xu, Xu, Xu, Xu, Xu, Uu, Xu, Xu, Xu, Xu, Xu, Xu, Xu, Xu, Xu, Xu, Xu
Xu, Xu, Xu, Xu, Xu, Xu, Xu, Xu, Xu, Xu, Xu, Xoa, Xu, Xu, Xu, Tb^Tf, Xu, Xu, Xu, Xu, Xu, Xu, Xu, Xu, 9 Ql, Uu, Xu, Xu, Xu, Xu, Xu, Xu, Xu, Xu, Xu, Xu, Xu
Xu, Xu, Xu, Xu, Xu, Xu, Xu, Xu, Xu, Xu, Xu, Xoa, Xu, Xu, Xu, Xu, Xu, Xu, Xu, Xu, Xu, Xu, Xu, Ql, Ql, Xu, Xu, Xu, Xu, Xu, Xu, Xu, Xu, Xu, Xu, Xu, Xu
