Xu, Xu, Xu, Xu, Xu, Xu, Xu, Xu, Xu, Xu, Xu, Xu, Xu, Xu, Xu, Xu, Xu, Xu, Aa^Fpa, Xu, Xu, Xu, Xu, Xu, Xu, Xu, Xu, Xu, Xu, Xu, Xu, Xu, Xu, Xu, Ur^Br|, Xu, Xu
Xu, Xu, Xu, Xu, Xu, Xu, Xu, Xu, Xu, Xu, Xu, Xu, Xu, Xu, Xu, Xu, Xu, Aa^Fpa, Aa^Fpa, Wwg, Xu, Xu, Xu, Xu, Xu, Xu, Xu, Xu, Xu, Xu, Xu, Xu, Ur^Br/, Xu, Ur^Br/, Xu, Xu
Xu, Xu, Xu, Xu, Xu, Xu, Xu, Xu, Xu, Xu, Xu, Xu, Xu, Xu, Cud, Xu, Xoa, Aa, Aa, Aa, Xu, Xu, Xu, Xu, Xu, Xu, Xu, Xu, Ai, Uh, Ur^Br|, Ur^Br/, Xu, Ur^Br\, Xu, Xu, Xu
Xu, Xu, Xu, Xu, Xu, Xu, Xu, Xu, Xu, Xu, Xu, Xu, Uu^Vu, Ql, 6 Kud, Ql, Ur^Es, Rb, Rb, Xoa, Xu, Xu, Xu, Xu, Xu, Xu, Xu, Xu, Uu, Ur, Ur^Br|, Ai, Xu, Xu, Xu, Xu, Xu
Xu, Xu, Xu, Xu, Xu, Xu, Xu, Xu, Xu, Xu, Xu, Xu, Ql, Cud, Uu^Vu, Uu, Uu, Ur, Ur^Es, Uh, Xu, Xu, Xu, Xu, Xu, Tb^Tf, Uu, Uh, Ur, Ur, Ur^Br|, Tb^Tf, Xu, Xu, Xu, Xu, Xu
Xu, Xu, Wwg, Aa^Fpa, Xu, Xu, Xu, Xu, Xu, Xu, Xu, Xu, Ql, Uu, Uh, Tb^Tf, Uh, Uu, Ur^Es, Uu, Uh, Tb^Tf, Xu, Xu, Xu, Uh, Ur^Br/, Ur^Br\, Ur^Br/, Ur^Br/, Xu, Xu, Xu, Xu, Xu, Xu, Xu
Xu, Xu, Xu, Aa, Aa^Esa, Xu, Uh, Tb^Tf, Xu, Xu, Xu, Wwg, Uh, Ur^Es, Ql, Uh, Xu, Xu, Xu, Ur^Es, Ur^Es, Xu, Uh, Xu, Ur^Br/, Ur^Br/, Uh, Uh, Tb^Tf, Xu, Uu, Xu, Xu, Xu, Xu, Xu, Xu
Xu, Xu, Xu, Aa, Rb, Xoa, Uh, Uu, Uu, Uu, Uu, Ur^Es, Uh, Uu, Uh, Xu, Xu, Xu, Uh, Ql, Wwg, Uu, Ur^Br\, Tb^Tf, Ur^Br|, Uh, Xu, Xu, Xu, Ur, Ur, Xu, Uu^Vu, Xu, Xu, Xu, Xu
Xu, Xu, Xu, Xoa, Ur, Ur^Es, Uu, Ur^Es, Ur, Ur, Ur, Ur^Es, Ur^Es, Uu, Tb^Tf, Xu, Kud, Xu, Uu^Vu, Uh, Ur^Br/, Ur^Br/, Xu, Ur^Br/, Ur^Es, Uh, Ur, Tb^Tf, Ur, Uh, Ur^Es, Ur^Es, Tb^Tf, Cud, 5 Kud, Xu, Xu
Xu, Xu, Xu, Tb^Tf, Cud, Uu^Vu, Tb^Tf, Ur, Uu, Uu, Xu, Uh, Xu, Uh, Xu, Xu, Cud, Cud, Tb^Tf, Ur^Br/, Ur^Es, Ql, Xu, Xu, Tb^Tf, Ur, Xu, Ur, Ur^Es, Ur^Es, Xu, Ur^Es, Ur, Uu^Vu, Cud, Xu, Xu
Xu, Xu, Xu, Xu, Uu^Vu, 4 Kud, Uh, Uu, Uu, Tb^Tf, Ql, Xu, Xu, Ur^Es, Ur^Es, Uu^Vu, Ur, Uu^Vu, Uu, Ur^Br|, Uu^Vu, Ql, Ql, Xu, Xu, Xu, Tb^Tf, Xu, Ur^Es, Ur, Xu, Xu, Uu, Ur^Es, Rb, Rb, Xoa
Xu, Xu, Xu, Xu, Xu, Cud, Ql, Ql, Uh, Ur, Ur^Es, Uh, Xu, Xu, Xu, Ur^Es, Uh, Uu, Ur^Br/, Ur^Br|, Tb^Tf, Cud, Uh, Xu, Xu, Wwg, Ur^Es, Uh, Ur^Es, Xu, Xu, Xu, Xu, Xoa, Rb, Aa^Esa, Aa^Fpa
Xu, Xu, Xu, Xu, Xu, Xu, Ql, Uh, Xu, Uu, Ur, Ur^Es, Ur, Xu, Wwg, Tb^Tf, Ur^Br|, Ur^Br/, Uh, Uu^Vu, Cud, Kud, Uu^Vu, Tb^Tf, Xu, Xu, Ur^Es, Ur, Tb^Tf, Xu, Uh, Xu, Xoa, Aa^Fpa, Aa, Aa^Fpa, Aa^Fpa
Xu, Xu, Xu, Xu, Xu, Xu, Xu, Xu, Xu, Xu, Xu, Tb^Tf, Ql, Ur, Ql, Uu, Ur^Br|, Ur^Es, Xu, Uu, Uh, Xu, Xu, Xu, Uh, Ur, Uu, Uu, Ur^Es, Uh, Ur, Uh, Rb, Aa^Esa, Aa^Fpa, Aa^Esa, Xu
Aa^Esa, Aa^Fpa, Wog, Aa^Fpa, Xu, Xu, Xu, Xu, Xu, Xu, Xu, Xu, Ql, Ql, Uh, Uu^Vu, Ur^Br|, Xu, Xu, Tb^Tf, Uu, Ql, Xu, Xu, Ur, Ur, Xu, Xu, Uu, Ur^Es, Ql, Ur, Xoa, Aa^Fpa, Aa^Fpa, Xu, Xu
Aa^Fpa, Aa^Fpa, Aa^Vca, Aa^Esa, Aa^Fpa, Xu, Xu, Xu, Xu, Xu, Xoa, Xu, Ur^Br/, Ur^Br/, Ur^Br\, Ur^Br/, Xu, Xu, Tb^Tf, Xu, Ur, Xu, Ql, Uu, Ur, Uu, Xu, Xu, Xu, Ql, Ql, Xu, Xu, Wwg, Xu, Xu, Xu
Rb, Aa, Rb, Aa, Aa, Aa^Fpa, Aa^Esa, Xu, Aa^Vca, Aa^Esa, Rb, Rb, Ur, Ur^Es, Uu^Vu, Xu, Xu, Uh, Uu, Uh, Uu, Xu, Xu, Tb^Tf, Ur, Uu, Uh, Tb^Tf, Uu, Xu, Xu, Xu, Xoa, Xu, Xu, Xu, Xu
Ur, Rb, Aa^Fpa, Rb, Rb, Rb, Rb, Aa, 2 Rb, Cea, 1 Kea, Xoa, Xu, Uh, Xu, Xu, Uu, Uh, Ql, Ur, Ur^Es, Xu, Xu, Ur, Uh, Uu, Xu, Uu, Ql, Wwg, Xu, Xu, Xu, Xu, Xu, Xu, Xu
Aa, Aa^Fpa, Aa, Aa, Aa^Esa, Aa, Rb, Aa, Rb, Cea, Aa^Vca, Aa^Esa, Xu, Xu, Uu, Xu, Uu, Uh, Ql, Uh, Ur^Es, Uh, Uu, Ur, Tb^Tf, Uh, Xu, Xu, Ql, Uh, Xu, Xu, Xu, Xu, Xu, Xu, Xu
Aa, Aa^Fpa, Aa^Esa, Aa^Fpa, Aa, Aa^Esa, Aa, Rb, Aa, Aa, Xu, Xu, Xu, Uh, Ur^Es, Uh, Uh, Tb^Tf, Uu, Ur, Uu, Uu, Uh, Cud, Ql, Ql, Xu, Xu, Xu, Xu, Xu, Xu, Xu, Xu, Xu, Xu, Xu
Aa^Fpa, Aa^Fpa, Aa, Aa^Fpa, Aa, Wwg, Xu, Aa, Aa^Fpa, Xu, Xu, Xu, Xu, Uh, Uh, Ur, Xu, Xu, Uh, Tb^Tf, Uu^Vu, Ur, Ur, 3 Kud, Cud, Ql, Xu, Xu, Xu, Xu, Xu, Xu, Xu, Xu, Xu, Xu, Xu
Aa^Fpa, Aa^Vca, Aa^Fpa, Aa, Aa^Fpa, Xu, Xu, Aa^Fpa, Aa, Xu, Xu, Xu, Xu, Xu, Ur, Ur, Xu, Xu, Xu, Xu, Xu, Ql, Ql, Uu^Vu, Xu, Xu, Xu, Xu, Xu, Xu, Xu, Xu, Xu, Xu, Xu, Xu, Xu
Aa^Fpa, Aa^Fpa, Aa^Esa, Aa, Xu, Xu, Xu, Xu, Xu, Xu, Xu, Xu, Xu, Xoa, Aa^Esa, Xoa, Xu, Xu, Xu, Xu, Xu, Ql, Ql, Uh, Xu, Xu, Xu, Xu, Xu, Xu, Xu, Xu, Xu, Xu, Xu, Xu, Xu
Aa^Fpa, Aa^Fpa, Xu, Xu, Xu, Xu, Xu, Xu, Xu, Xu, Xu, Xu, Xu, Aa^Fpa, Aa, Aa^Esa, Xu, Xu, Xu, Xu, Xu, Xu, Xu, Xu, Xu, Xu, Xu, Xu, Xu, Xu, Xu, Xu, Xu, Xu, Xu, Xu, Xu
Aa^Fpa, Aa^Fpa, Xu, Xu, Xu, Xu, Xu, Xu, Xu, Xu, Xu, Xu, Xu, Wwg, Aa^Fpa, Xu, Xu, Xu, Xu, Xu, Xu, Xu, Xu, Xu, Xu, Xu, Xu, Xu, Xu, Xu, Xu, Xu, Xu, Xu, Xu, Xu, Xu
Xu, Xu, Xu, Xu, Xu, Xu, Xu, Xu, Xu, Xu, Xu, Xoa, Xu, Xu, Xu, Aa, Xu, Xu, Xu, Xu, Xu, Xu, Xu, Xu, Xu, Xu, Xu, Xu, Xu, Xu, Xu, Xu, Xu, Xu, Xu, Xu, Xu
Xu, Xu, Xu, Xu, Xu, Xu, Xu, Xu, Xu, Xu, Xu, Xu, Xu, Xu, Xu, Xu, Xu, Xu, Xu, Xu, Xu, Xu, Xu, Xu, Xu, Xu, Xu, Xu, Xu, Xu, Xu, Xu, Xu, Xu, Xu, Xu, Xu
