Xu, Xu, Xu, Xu, Xu, Xu, Xu, Xu, Ql, Ql, Uh, Uu, Uu, Uh, Uu, Ql, Ql, Ql, Xu, Xu, Xu
Xu, Xu, Cud, Uu^Vu, Uh, Xu, Tb^Tf, Uu^Vu, Ql, Uu, Ql, Tb^Tf, Uu, Uh, Ql, Ql, Ql, Ql, Xu, Xu, Xu
Xu, 4 Kud, Cud, Cud, Uu, Uu^Es, Uh, Uu, Uu^Es, Ql, Ql, Uu^Es, Uu^Es, Ql, Ql, Xu, Xoa, Xoa, Xoa, Xu, Xu
Xu, Cud, Tb^Tf, Ur, Uh, Ur^Em, Tb^Tf, Ur^Edt, Uu^Vu, Ur, Ur^Edt, Ql, Ql, Ql, Xoa, Xoa, Ias, Ias, Ias, Xoa, Xoa
Xu, Xu, Uh, Uu^Edb, Uu^Es, Uu^Es, Ur, Uu^Em, Uh, Tb^Tf, Ql, Ql, Ur, Ql, Ql, Ias^Ebn, Ias, Tsv, Ias, Ias^Ebn, Xoa
Xu, Xu, Ur^Edt, Ur, Uh, Tb^Tf, Ql, Ias^Edb, Ql^Bs\, Ql, Cud, Ql, Ql, Ql, Ias, Ias, Ias, Ias, Xoa, Xoa, Xu
Xu, Uu^Vu, Uu, Uh, Uh, Ql, Ql, Ql, Cud, Ias^Ii, Ias^Edb, Cud, Ias^Ii, Ql^Bs/, Ql, Ias, Xoa, Xoa, Ql, Ql, Ql
Xu, Uu^Edb, Tb^Tf, Uu, Uu, Ql, Ql, Cud, 1 Kud, Ias^Vud, Ias, Ias, 2 Kud, Cud, Ql, Ql, Xoa, Xu, Ql, Uu, Uh
Ql, Ql, Ql, Ql, Ql, Uu, Ql, Ias^Edb, Ias^Ii, Ias, Ias^Edb, Ias^Vud, Ias^Edb, Cud, Ql, Ql, Ql, Ql, Uh, Uu, Uh
Ql, Xu, Xoa, Xoa, Xoa, Ql, Ias, Ql^Bs/, Ql, Cud, Cud, Ias^Ii, Ql^Bs\, Ql, Ql, Uu, Ur^Edt, Uu^Vu, Uu^Es, Tb^Tf, Xu
Xoa, Xoa, Ias, Ias, Ias, Ias, Ias, Ias, Ql, Ql, Ql, Ql, Ql, Ias^Edb, Ur, Tb^Tf, Uh, Ur^Em, Uh, Xu, Xu
Xoa, Ias^Ebn, Ias, Tsv, Ias, Ias^Ebn, Ql, Ql, Uu^Es, Ql, Ur^Edt, Ql, Tb^Tf, Uu^Vu, Uh, Uu, Ur^Edb, Tb^Tf, Cud, Uu^Vu, Xu
Xu, Xoa, Xoa, Ias, Xoa, Xoa, Ql, Uu, 3 Uu^Em, Ql, Ql, Ur, Uh, Ur, Ur^Es, Uu^Edt, Uh^Es, Cud, 5 Kud, Cud, Xu
Xu, Xu, Xu, Xu, Xu, Ql, Uu, Uh, Uu, Tb^Tf, Ql, Uh, Uu^Vu, Uu^Em, Uu, Tb^Tf, Xu, Cud, Xu, Xu, Xu
Xu, Xu, Xu, Xu, Xu, Ql, Xu, Uu, Uh, Uh, Ql, Uu, Uu, Ur, Uu, Uh, Xu, Xu, Xu, Xu, Xu
